scheme_code,scheme_name,completion_date,estimated_cost,estimated_material,expenditure_wage,expenditure_material,sanctiondate,wage_expense,semiskilled_expense,skilled_expense,material_expense,contingency_expense,total_expense,mandays
(3201009002/FP/320201060425771),Earth work in earthen bundh for flood protection on bundh from H/O Sukumar Bag to H/O Dula Majhi . ,03/09/2019 ,136620 ,11100 ,96460 ,10100 ,06/12/2017,96460,0,8100,2000,0  ,106560,
(3201009002/IF/IAY/2146327),Construction of PMAY-G House for Individuals -PMAY-G  REG. NO. WB1984216 ,02/07/2019 ,17190 ,0 ,16808 ,0 ,24/01/2018,16808,0,0,0,0  ,16808,
(3201009002/IF/IAY/2145640),Construction of PMAY-G House for Individuals -PMAY-G  REG. NO. WB1475584 ,02/07/2019 ,17190 ,0 ,16999 ,0 ,24/01/2018,16999,0,0,0,0  ,16999,
(3201009002/IF/IAY/2133077),Construction of PMAY-G House for Individuals -PMAY-G  REG. NO. WB3280691 ,02/07/2019 ,17190 ,0 ,16235 ,0 ,12/02/2018,16235,0,0,0,0  ,16235,
(3201009002/IF/IAY/1059120),Construction of IAY House -IAY REG. NO. WB1904188 ,02/07/2019 ,15840 ,0 ,13552 ,0 ,17/02/2017,13552,0,0,0,0  ,13552,
(3201009002/IF/IAY/1313128),Construction of IAY House -IAY REG. NO. WB1701472 ,02/12/2019 ,16200 ,0 ,15912 ,0 ,09/02/2017,15912,0,0,0,0  ,15912,
(3201009002/IF/IAY/1316499),Construction of IAY House -IAY REG. NO. WB2546180 ,02/07/2019 ,16200 ,0 ,15912 ,0 ,09/04/2017,15912,0,0,0,0  ,15912,
(3201009002/IF/IAY/1059007),Construction of IAY House -IAY REG. NO. WB1871178 ,11/09/2019 ,15840 ,0 ,11616 ,0 ,17/02/2017,11616,0,0,0,0  ,11616,
(3201009002/IF/IAY/1422233),Construction of IAY House -IAY REG. NO. WB1426087 ,02/12/2019 ,16200 ,0 ,15912 ,0 ,13/08/2017,15912,0,0,0,0  ,15912,
(3201009002/IF/IAY/2139794),Construction of PMAY-G House for Individuals -PMAY-G  REG. NO. WB1511393 ,23/09/2019 ,17190 ,0 ,16044 ,0 ,12/02/2018,16044,0,0,0,0  ,16044,
(3201009002/IF/IAY/2135835),Construction of PMAY-G House for Individuals -PMAY-G  REG. NO. WB1546035 ,02/07/2019 ,17190 ,0 ,16808 ,0 ,21/02/2018,16808,0,0,0,0  ,16808,
(3201009002/IF/IAY/2137760),Construction of PMAY-G House for Individuals -PMAY-G  REG. NO. WB2806501 ,23/09/2019 ,17190 ,0 ,16044 ,0 ,24/01/2018,16044,0,0,0,0  ,16044,
(3201009002/IF/IAY/4116661),Construction of PMAY-G House for Individuals -PMAY-G  REG. NO. WB3387484 ,15/05/2022 ,20070 ,0 ,18936 ,0 ,24/06/2020,18936,0,0,0,0  ,18936,
(3201009002/IF/321002041046410),EXCAVATION OF FARM POND ON THE L/O BISHNU CH. DAS AT ANANDABAS UNDER BHALUKA GP ,10/03/2020 ,94907.59 ,3000 ,92590 ,5756 ,22/11/2019,92590,0,2760,2996,0  ,98346,
(3201009002/IF/IAY/4117689),Construction of PMAY-G House for Individuals -PMAY-G  REG. NO. WB2862092 ,15/05/2022 ,20070 ,0 ,18936 ,0 ,10/06/2020,18936,0,0,0,0  ,18936,
(3201009002/IF/321002041046408),EXCAVATION OF FARM POND ON THE L/O HARIKALI DAS AT ANANDABAS UNDER BHALUKA GP ,29/03/2020 ,238840.16 ,3000 ,192985 ,10083 ,18/11/2019,192985,0,7087,2996,0  ,203068,
(3201009002/IF/IAY/4117580),Construction of PMAY-G House for Individuals -PMAY-G  REG. NO. WB3437838 ,15/09/2021 ,19170 ,0 ,18822 ,0 ,29/06/2020,18822,0,0,0,0  ,18822,
(3201009002/IF/IAY/4117650),Construction of PMAY-G House for Individuals -PMAY-G  REG. NO. WB1582433 ,15/09/2021 ,19170 ,0 ,18822 ,0 ,24/06/2020,18822,0,0,0,0  ,18822,
(3201009002/RC/320201060593600),Earth work and Jhama Bats from h/o Akher Sk to Lutharian Bundh at Anandabasd. ,30/03/2022 ,76773.32 ,259661.02 ,60712 ,0 ,21/12/2020,60712,0,0,0,0  ,60712,
(3201009002/IF/IAY/4117709),Construction of PMAY-G House for Individuals -PMAY-G  REG. NO. WB3415208 ,02/10/2021 ,19170 ,0 ,18822 ,0 ,29/06/2020,18822,0,0,0,0  ,18822,
(3201009002/IF/IAY/2283222),Construction of PMAY-G House for Individuals -PMAY-G  REG. NO. WB1509006 ,04/01/2019 ,17190 ,0 ,17190 ,0 ,05/06/2018,17190,0,0,0,0  ,17190,
(3201009002/WC/704010332061),Exacavation of from pond of Masadul sk at Hatdanga. ,07/05/2018 ,203220 ,40650 ,130350 ,10370 ,15/05/2017,130350,0,8370,2000,0  ,140720,
(3201009002/WC/704010330483),Excavation of farm pond of Sumanta das at Anandabas. ,07/05/2018 ,170820 ,38760 ,66330 ,6320 ,26/04/2017,66330,0,4320,2000,0  ,72650,
(3201009002/WC/704010330478),Excavation of farm pond of Sushil Das at Anandabas. ,07/05/2018 ,235260 ,42540 ,139449 ,11180 ,26/04/2017,139449,0,9180,2000,0  ,150629,
(3201009002/WC/704010330487),Excavation of farm pond of prahallad Santra at satkuliya. ,07/05/2018 ,349740 ,49560 ,70556 ,8210 ,28/04/2017,70556,0,6210,2000,0  ,78766,
(3201009002/IF/IAY/2283223),Construction of PMAY-G House for Individuals -PMAY-G  REG. NO. WB1509357 ,04/01/2019 ,17190 ,0 ,17190 ,0 ,05/06/2018,17190,0,0,0,0  ,17190,
(3201009002/IF/IAY/2160701),Construction of PMAY-G House for Individuals -PMAY-G  REG. NO. WB3664349 ,08/01/2019 ,17190 ,0 ,17190 ,0 ,21/02/2018,17190,0,0,0,0  ,17190,
(3201009002/WC/704010325628),Re excavation of pond of Bhaluka Matsha samabay samity at Bhaluka under Bhaluka G.P under Kgr-1 ,07/05/2018 ,310680 ,22380 ,152132 ,13880 ,17/04/2017,152132,0,11880,2000,0  ,166012,
(3201009002/RC/320201060383616),Construction of cc road from h/o Gobinda Mallick to H/O Satyen Sinha at Bhaluka Gp. ,27/04/2018 ,7920 ,131049 ,6160 ,3028 ,09/02/2017,6160,0,528,2500,0  ,9188,
(3201009002/WC/704010332690),Excavation of farm pond of Rabindranath Mistri at Bhaluka . ,16/07/2018 ,219240 ,41730 ,145831 ,12596 ,22/05/2017,145831,0,10596,2000,0  ,158427,
(3201009002/IF/IAY/2160857),Construction of PMAY-G House for Individuals -PMAY-G  REG. NO. WB1511458 ,22/01/2019 ,17190 ,0 ,17190 ,0 ,12/02/2018,17190,0,0,0,0  ,17190,
(3201009002/RC/320201060383067),Construction of concrete road from the H/O Palash Santra to H/O shyam Santra at natunpara. ,27/04/2018 ,7920 ,131049 ,4928 ,2764 ,09/02/2017,4928,0,264,2500,0  ,7692,
(3201009002/WC/704010334659),Excavation of farm pond of Sanjay Ghosh at Jangalbas. ,07/05/2018 ,90180 ,33900 ,69450 ,6050 ,29/05/2017,69450,0,4050,2000,0  ,75500,
(3201009002/RC/320201060379010),Construction of concrete road from H/O Ukil Sk to Pirhak Sk at Anandabas. ,27/04/2018 ,15136 ,241474 ,13200 ,792 ,09/02/2017,13200,0,792,0,0  ,13992,
(3201009002/RC/320201060578452),Construction of jhama bats from H/O-Babu Sk to H/O-Akubar Mondal at Anandabas. ,30/03/2022 ,54838.08 ,186989.78 ,18196 ,0 ,21/12/2020,18196,0,0,0,0  ,18196,
(3201009002/RC/320201060379070),Construction of concrete road from the H/O Biren Biswas to h/o Mantu Biswas at Bhaluka. ,27/04/2018 ,13376 ,225809 ,12672 ,3028 ,09/02/2017,12672,0,528,2500,0  ,15700,
(3201009002/RC/320201060378328),Construction of concrete road from Temple of shiva to h/o Plan Halder in Bhaluka . ,27/04/2018 ,15664 ,258598 ,15136 ,5792 ,09/02/2017,15136,0,792,5000,0  ,20928,
(3201009002/RC/320201060343273),8 Earth work in road embankment from the L/O Chhaidali Mondal to L/O Golam sk at Anandabas. ,26/04/2018 ,119504 ,13828 ,112086 ,8364 ,16/06/2016,112086,0,6864,1500,0  ,120450,
(3201009002/RC/320201060343197),9 Earth work in road embankment from the L/O Tancher sk to L/O Haidel sk at Anandabas. ,26/04/2018 ,125664 ,14356 ,116213 ,7836 ,21/06/2016,116213,0,6336,1500,0  ,124049,
(3201009002/RC/320201060378397),Construction of concrete road from the h/o Ramen Karmakar to h/o Kismat Sekh at Bhaluka. ,27/04/2018 ,14608 ,241538 ,14432 ,3292 ,09/02/2017,14432,0,792,2500,0  ,17724,
(3201009002/RC/320201060343056),12 Earth work in road from the L/O Kiyamuddin sk to H/O Akram Mondal at Hatdanga. ,26/04/2018 ,121440 ,14092 ,102720 ,8364 ,21/06/2016,102720,0,6864,1500,0  ,111084,
(3201009002/RC/320201060378093),Construction of concrete road from H/O Lokman Mondal to Masjid at Anandabas. ,27/04/2018 ,15664 ,258598 ,14784 ,3292 ,09/02/2017,14784,0,792,2500,0  ,18076,
(3201009002/LD/321002040763182),Land development on the land of Sijaipur Primary school at sijaipur. ,06/12/2018 ,61200 ,7280 ,33435 ,4160 ,04/05/2017,33435,0,2160,2000,0  ,37595,
(3201009002/RC/320201060343195),11 Earth work in road from the h/o Masurali sk to L/O Gadai sk at Anandabas. ,26/04/2018 ,123024 ,14092 ,104503 ,6252 ,21/06/2016,104503,0,4752,1500,0  ,110755,
(3201009002/RC/320201060378188),Construction concrete road from h/o Bhakta Dhara to Jaydeb Halsana at Satkuliya. ,27/04/2018 ,15664 ,258598 ,13728 ,3292 ,09/02/2017,13728,0,792,2500,0  ,17020,
(3201009002/RC/320201060381784),Construction of cc road from h/o Raju Mondal to h/o Kashinath Sen at Hatdanga.  ,27/04/2018 ,8448 ,139439 ,7040 ,3028 ,09/02/2017,7040,0,528,2500,0  ,10068,
(3201009002/RC/320201060383651),construction of cc road from the H/O Nousad sk to H/O ajit Biswas at hatdanga. ,27/04/2018 ,8448 ,139439 ,7040 ,3028 ,09/02/2017,7040,0,528,2500,0  ,10068,
(3201009002/IF/IAY/983337),Construction of IAY House -IAY REG. NO. WB1885711 ,03/07/2018 ,15840 ,0 ,15840 ,0 ,09/02/2017,15840,0,0,0,0  ,15840,
(3201009002/IF/IAY/977399),Construction of IAY House -IAY REG. NO. WB1222032 ,10/07/2018 ,15840 ,0 ,15840 ,0 ,02/02/2017,15840,0,0,0,0  ,15840,
(3201009002/IF/IAY/955557),Construction of IAY House -IAY REG. NO. WB1287383 ,03/07/2018 ,15840 ,0 ,15840 ,0 ,28/01/2017,15840,0,0,0,0  ,15840,
(3201009002/IF/IAY/982949),Construction of IAY House -IAY REG. NO. WB1164717 ,03/07/2018 ,15840 ,0 ,15840 ,0 ,09/02/2017,15840,0,0,0,0  ,15840,
(3201009002/RC/320201060381688),Construction of CC road from the H/O Jamat sk to h/o Naskar sk. ,27/04/2018 ,8448 ,139439 ,7040 ,3028 ,09/02/2017,7040,0,528,2500,0  ,10068,
(3201009002/IF/IAY/2314138),Construction of PMAY-G House for Individuals -PMAY-G  REG. NO. WB5106132 ,19/11/2018 ,17190 ,0 ,17190 ,0 ,21/02/2018,17190,0,0,0,0  ,17190,
(3201009002/IF/IAY/552057),Construction of IAY House -IAY REG. NO. WB-01-009-002-002/602 ,03/07/2018 ,15660 ,0 ,15660 ,0 ,15/07/2015,15660,0,0,0,0  ,15660,
(3201009002/IF/IAY/2312148),Construction of PMAY-G House for Individuals -PMAY-G  REG. NO. WB4614954 ,19/11/2018 ,17190 ,0 ,17190 ,0 ,24/01/2018,17190,0,0,0,0  ,17190,
(3201009002/IF/IAY/983777),Construction of IAY House -IAY REG. NO. WB2242278 ,10/07/2018 ,15840 ,0 ,15840 ,0 ,09/02/2017,15840,0,0,0,0  ,15840,
(3201009002/IF/IAY/552291),Construction of IAY House -IAY REG. NO. WB-01-009-002-006/2314 ,03/07/2018 ,15660 ,0 ,15660 ,0 ,15/07/2015,15660,0,0,0,0  ,15660,
(3201009002/IF/IAY/552310),Construction of IAY House -IAY REG. NO. WB-01-009-002-003/1054 ,03/07/2018 ,15660 ,0 ,15660 ,0 ,15/07/2015,15660,0,0,0,0  ,15660,
(3201009002/IF/IAY/2300412),Construction of PMAY-G House for Individuals -PMAY-G  REG. NO. WB2937369 ,01/11/2018 ,17190 ,0 ,17190 ,0 ,24/01/2018,17190,0,0,0,0  ,17190,
(3201009002/IF/IAY/2293350),Construction of PMAY-G House for Individuals -PMAY-G  REG. NO. WB2281162 ,04/01/2019 ,17190 ,0 ,17190 ,0 ,05/06/2018,17190,0,0,0,0  ,17190,
(3201009002/IF/IAY/2293189),Construction of PMAY-G House for Individuals -PMAY-G  REG. NO. WB2272814 ,04/01/2019 ,17190 ,0 ,17190 ,0 ,05/06/2018,17190,0,0,0,0  ,17190,
(3201009002/IF/IAY/2292449),Construction of PMAY-G House for Individuals -PMAY-G  REG. NO. WB2222755 ,04/01/2019 ,17190 ,0 ,17190 ,0 ,05/06/2018,17190,0,0,0,0  ,17190,
(3201009002/IF/IAY/2307542),Construction of PMAY-G House for Individuals -PMAY-G  REG. NO. WB3663737 ,19/11/2018 ,17190 ,0 ,17190 ,0 ,21/02/2018,17190,0,0,0,0  ,17190,
(3201009002/IF/IAY/2307540),Construction of PMAY-G House for Individuals -PMAY-G  REG. NO. WB3663706 ,04/01/2019 ,17190 ,0 ,17190 ,0 ,24/01/2018,17190,0,0,0,0  ,17190,
(3201009002/IF/IAY/965568),Construction of IAY House -IAY REG. NO. WB1846814 ,03/07/2018 ,15840 ,0 ,15840 ,0 ,28/01/2017,15840,0,0,0,0  ,15840,
(3201009002/IF/IAY/2283503),Construction of PMAY-G House for Individuals -PMAY-G  REG. NO. WB1546247 ,04/01/2019 ,17190 ,0 ,17190 ,0 ,05/06/2018,17190,0,0,0,0  ,17190,
(3201009002/IF/IAY/2283715),Construction of PMAY-G House for Individuals -PMAY-G  REG. NO. WB1523121 ,04/01/2019 ,17190 ,0 ,17190 ,0 ,05/06/2018,17190,0,0,0,0  ,17190,
(3201009002/IF/IAY/2288410),Construction of PMAY-G House for Individuals -PMAY-G  REG. NO. WB1921510 ,04/01/2019 ,17190 ,0 ,17190 ,0 ,05/06/2018,17190,0,0,0,0  ,17190,
(3201009002/IF/IAY/2283230),Construction of PMAY-G House for Individuals -PMAY-G  REG. NO. WB1509650 ,29/12/2018 ,17190 ,0 ,17190 ,0 ,05/06/2018,17190,0,0,0,0  ,17190,
(3201009002/IF/IAY/2283341),Construction of PMAY-G House for Individuals -PMAY-G  REG. NO. WB1526917 ,29/12/2018 ,17190 ,0 ,17190 ,0 ,05/06/2018,17190,0,0,0,0  ,17190,
(3201009002/IF/IAY/2283221),Construction of PMAY-G House for Individuals -PMAY-G  REG. NO. WB1508997 ,29/12/2018 ,17190 ,0 ,17190 ,0 ,05/06/2018,17190,0,0,0,0  ,17190,
(3201009002/IF/IAY/2283090),Construction of PMAY-G House for Individuals -PMAY-G  REG. NO. WB1489148 ,04/01/2019 ,17190 ,0 ,17190 ,0 ,05/06/2018,17190,0,0,0,0  ,17190,
(3201009002/IF/IAY/2283040),Construction of PMAY-G House for Individuals -PMAY-G  REG. NO. WB1479873 ,04/01/2019 ,17190 ,0 ,17190 ,0 ,05/06/2018,17190,0,0,0,0  ,17190,
(3201009002/IF/IAY/2283039),Construction of PMAY-G House for Individuals -PMAY-G  REG. NO. WB1479709 ,04/01/2019 ,17190 ,0 ,17190 ,0 ,05/06/2018,17190,0,0,0,0  ,17190,
(3201009002/IF/IAY/2163454),Construction of PMAY-G House for Individuals -PMAY-G  REG. NO. WB3851573 ,22/01/2019 ,17190 ,0 ,17190 ,0 ,12/02/2018,17190,0,0,0,0  ,17190,
(3201009002/IF/IAY/2291215),Construction of PMAY-G House for Individuals -PMAY-G  REG. NO. WB2132605 ,01/11/2018 ,17190 ,0 ,17190 ,0 ,12/02/2018,17190,0,0,0,0  ,17190,
(3201009002/IF/IAY/983263),Construction of IAY House -IAY REG. NO. WB1664580 ,03/07/2018 ,15840 ,0 ,15840 ,0 ,08/02/2017,15840,0,0,0,0  ,15840,
(3201009002/IF/IAY/2283110),Construction of PMAY-G House for Individuals -PMAY-G  REG. NO. WB1491114 ,29/12/2018 ,17190 ,0 ,17190 ,0 ,05/06/2018,17190,0,0,0,0  ,17190,
(3201009002/IF/IAY/2163324),Construction of PMAY-G House for Individuals -PMAY-G  REG. NO. WB3309560 ,04/01/2019 ,17190 ,0 ,17190 ,0 ,12/02/2018,17190,0,0,0,0  ,17190,
(3201009002/IF/IAY/2162674),Construction of PMAY-G House for Individuals -PMAY-G  REG. NO. WB2574409 ,22/01/2019 ,17190 ,0 ,17190 ,0 ,24/01/2018,17190,0,0,0,0  ,17190,
(3201009002/IF/IAY/2162209),Construction of PMAY-G House for Individuals -PMAY-G  REG. NO. WB3785623 ,22/01/2019 ,17190 ,0 ,17190 ,0 ,12/02/2018,17190,0,0,0,0  ,17190,
(3201009002/IF/IAY/2162203),Construction of PMAY-G House for Individuals -PMAY-G  REG. NO. WB2317179 ,22/01/2019 ,17190 ,0 ,17190 ,0 ,12/02/2018,17190,0,0,0,0  ,17190,
(3201009002/IF/IAY/2163157),Construction of PMAY-G House for Individuals -PMAY-G  REG. NO. WB1509528 ,22/01/2019 ,17190 ,0 ,17190 ,0 ,12/02/2018,17190,0,0,0,0  ,17190,
(3201009002/IF/IAY/2161949),Construction of PMAY-G House for Individuals -PMAY-G  REG. NO. WB2244925 ,08/01/2019 ,17190 ,0 ,17190 ,0 ,12/02/2018,17190,0,0,0,0  ,17190,
(3201009002/IF/IAY/2283092),Construction of PMAY-G House for Individuals -PMAY-G  REG. NO. WB1489470 ,04/01/2019 ,17190 ,0 ,17190 ,0 ,05/06/2018,17190,0,0,0,0  ,17190,
(3201009002/IF/IAY/977458),Construction of IAY House -IAY REG. NO. WB1282974 ,03/07/2018 ,15840 ,0 ,15840 ,0 ,02/02/2017,15840,0,0,0,0  ,15840,
(3201009002/IF/IAY/2309714),Construction of PMAY-G House for Individuals -PMAY-G  REG. NO. WB3957275 ,04/01/2019 ,17190 ,0 ,17190 ,0 ,05/06/2018,17190,0,0,0,0  ,17190,
(3201009002/IF/IAY/2162018),Construction of PMAY-G House for Individuals -PMAY-G  REG. NO. WB1491039 ,08/01/2019 ,17190 ,0 ,17190 ,0 ,24/01/2018,17190,0,0,0,0  ,17190,
(3201009002/IF/IAY/2159874),Construction of PMAY-G House for Individuals -PMAY-G  REG. NO. WB3258571 ,02/11/2018 ,17190 ,0 ,17954 ,0 ,12/02/2018,17954,0,0,0,0  ,17954,
(3201009002/IF/IAY/2160275),Construction of PMAY-G House for Individuals -PMAY-G  REG. NO. WB3318844 ,29/12/2018 ,17190 ,0 ,17190 ,0 ,12/02/2018,17190,0,0,0,0  ,17190,
(3201009002/IF/IAY/2158665),Construction of PMAY-G House for Individuals -PMAY-G  REG. NO. WB3794629 ,08/01/2019 ,17190 ,0 ,17190 ,0 ,12/02/2018,17190,0,0,0,0  ,17190,
(3201009002/IF/IAY/2162271),Construction of PMAY-G House for Individuals -PMAY-G  REG. NO. WB3829460 ,22/01/2019 ,17190 ,0 ,17190 ,0 ,12/02/2018,17190,0,0,0,0  ,17190,
(3201009002/IF/IAY/2159816),Construction of PMAY-G House for Individuals -PMAY-G  REG. NO. WB3528613 ,19/12/2018 ,17190 ,0 ,17190 ,0 ,24/01/2018,17190,0,0,0,0  ,17190,
(3201009002/IF/IAY/2159888),Construction of PMAY-G House for Individuals -PMAY-G  REG. NO. WB2193386 ,19/12/2018 ,17190 ,0 ,17190 ,0 ,24/01/2018,17190,0,0,0,0  ,17190,
(3201009002/IF/IAY/2157903),Construction of PMAY-G House for Individuals -PMAY-G  REG. NO. WB3317172 ,01/11/2018 ,17190 ,0 ,17190 ,0 ,12/02/2018,17190,0,0,0,0  ,17190,
(3201009002/IF/IAY/2157194),Construction of PMAY-G House for Individuals -PMAY-G  REG. NO. WB1553782 ,08/01/2019 ,17190 ,0 ,17190 ,0 ,21/02/2018,17190,0,0,0,0  ,17190,
(3201009002/IF/IAY/2158052),Construction of PMAY-G House for Individuals -PMAY-G  REG. NO. WB2352070 ,22/01/2019 ,17190 ,0 ,17190 ,0 ,24/01/2018,17190,0,0,0,0  ,17190,
(3201009002/IF/IAY/2155489),Construction of PMAY-G House for Individuals -PMAY-G  REG. NO. WB1475740 ,19/11/2018 ,17190 ,0 ,17190 ,0 ,24/01/2018,17190,0,0,0,0  ,17190,
(3201009002/RC/320201060593595),Earth work and Jhama Bats from h/o Rahaman Sk to Gadai Sk at Ananadabas ,30/03/2022 ,71594.82 ,261981.87 ,57953 ,0 ,21/12/2020,57953,0,0,0,0  ,57953,
(3201009002/IF/IAY/2162996),Construction of PMAY-G House for Individuals -PMAY-G  REG. NO. WB1620187 ,19/12/2018 ,17190 ,0 ,17190 ,0 ,12/02/2018,17190,0,0,0,0  ,17190,
(3201009002/RS/34041048100),Composed pit at Bhaluka High School. ,07/05/2018 ,4320 ,470 ,4224 ,200 ,04/05/2017,4224,0,0,200,0  ,4424,
(3201009002/IF/IAY/2156214),Construction of PMAY-G House for Individuals -PMAY-G  REG. NO. WB1953004 ,22/01/2019 ,17190 ,0 ,17190 ,0 ,24/01/2018,17190,0,0,0,0  ,17190,
(3201009002/IF/IAY/2155327),Construction of PMAY-G House for Individuals -PMAY-G  REG. NO. WB2275802 ,22/01/2019 ,17190 ,0 ,17190 ,0 ,12/02/2018,17190,0,0,0,0  ,17190,
(3201009002/IF/IAY/2156772),Construction of PMAY-G House for Individuals -PMAY-G  REG. NO. WB3315969 ,08/01/2019 ,17190 ,0 ,17190 ,0 ,12/02/2018,17190,0,0,0,0  ,17190,
(3201009002/RC/320201060584945),Construction of CC road from the Sanjay santra to Babu Porel at Bhaluka Sijaipur ,30/03/2022 ,16793.96 ,254849.1 ,15132 ,0 ,16/10/2020,15132,0,0,0,0  ,15132,
(3201009002/IF/IAY/2153928),Construction of PMAY-G House for Individuals -PMAY-G  REG. NO. WB3311055 ,19/12/2018 ,17190 ,0 ,17190 ,0 ,12/02/2018,17190,0,0,0,0  ,17190,
(3201009002/IF/IAY/2154180),Construction of PMAY-G House for Individuals -PMAY-G  REG. NO. WB2222668 ,19/12/2018 ,17190 ,0 ,17190 ,0 ,24/01/2018,17190,0,0,0,0  ,17190,
(3201009002/IF/IAY/2153684),Construction of PMAY-G House for Individuals -PMAY-G  REG. NO. WB3289980 ,29/12/2018 ,17190 ,0 ,17190 ,0 ,12/02/2018,17190,0,0,0,0  ,17190,
(3201009002/IF/IAY/2155050),Construction of PMAY-G House for Individuals -PMAY-G  REG. NO. WB1483822 ,19/12/2018 ,17190 ,0 ,17190 ,0 ,12/02/2018,17190,0,0,0,0  ,17190,
(3201009002/IF/IAY/2153872),Construction of PMAY-G House for Individuals -PMAY-G  REG. NO. WB2134787 ,19/11/2018 ,17190 ,0 ,17190 ,0 ,12/02/2018,17190,0,0,0,0  ,17190,
(3201009002/RC/320201060593587),Construction of CC road from h/o Babu Halsana to h/o Chandu Majhi at Natunpara. ,30/03/2022 ,6124.01 ,87780.68 ,4896 ,0 ,21/12/2020,4896,0,0,0,0  ,4896,
(3201009002/IF/IAY/2153259),Construction of PMAY-G House for Individuals -PMAY-G  REG. NO. WB1953010 ,08/01/2019 ,17190 ,0 ,17190 ,0 ,24/01/2018,17190,0,0,0,0  ,17190,
(3201009002/RC/320201060507016),Construction of CC road from the H/O Dayal sk  to Hasen Sk at Anandabas. ,09/06/2021 ,21392 ,324500 ,19100 ,114736.1375 ,04/01/2019,19100,18420,1146,95170.1375,0  ,133836.1375,
(3201009002/IF/IAY/2158940),Construction of PMAY-G House for Individuals -PMAY-G  REG. NO. WB3824375 ,08/01/2019 ,17190 ,0 ,17190 ,0 ,24/01/2018,17190,0,0,0,0  ,17190,
(3201009002/IF/IAY/4117734),Construction of PMAY-G House for Individuals -PMAY-G  REG. NO. WB2231115 ,15/09/2021 ,19170 ,0 ,18822 ,0 ,29/06/2020,18822,0,0,0,0  ,18822,
(3201009002/IF/IAY/4117746),Construction of PMAY-G House for Individuals -PMAY-G  REG. NO. WB2159536 ,15/09/2021 ,19170 ,0 ,18822 ,0 ,29/06/2020,18822,0,0,0,0  ,18822,
(3201009002/IF/IAY/4117743),Construction of PMAY-G House for Individuals -PMAY-G  REG. NO. WB3030011 ,15/09/2021 ,19170 ,0 ,18822 ,0 ,06/07/2020,18822,0,0,0,0  ,18822,
(3201009002/IF/IAY/2151646),Construction of PMAY-G House for Individuals -PMAY-G  REG. NO. WB3313822 ,04/01/2019 ,17190 ,0 ,17190 ,0 ,12/02/2018,17190,0,0,0,0  ,17190,
(3201009002/IF/IAY/2152775),Construction of PMAY-G House for Individuals -PMAY-G  REG. NO. WB1496015 ,19/12/2018 ,17190 ,0 ,17190 ,0 ,12/02/2018,17190,0,0,0,0  ,17190,
(3201009002/IF/IAY/2151305),Construction of PMAY-G House for Individuals -PMAY-G  REG. NO. WB3807578 ,08/01/2019 ,17190 ,0 ,17190 ,0 ,12/02/2018,17190,0,0,0,0  ,17190,
(3201009002/IF/IAY/2151198),Construction of PMAY-G House for Individuals -PMAY-G  REG. NO. WB3798542 ,26/10/2018 ,17190 ,0 ,17190 ,0 ,12/02/2018,17190,0,0,0,0  ,17190,
(3201009002/IF/IAY/2151520),Construction of PMAY-G House for Individuals -PMAY-G  REG. NO. WB1509066 ,29/12/2018 ,17190 ,0 ,17190 ,0 ,12/02/2018,17190,0,0,0,0  ,17190,
(3201009002/IF/IAY/4117704),Construction of PMAY-G House for Individuals -PMAY-G  REG. NO. WB3048869 ,15/09/2021 ,19170 ,0 ,18822 ,0 ,29/06/2020,18822,0,0,0,0  ,18822,
(3201009002/IF/IAY/4117688),Construction of PMAY-G House for Individuals -PMAY-G  REG. NO. WB3062721 ,15/09/2021 ,19170 ,0 ,18822 ,0 ,06/07/2020,18822,0,0,0,0  ,18822,
(3201009002/IF/IAY/2151340),Construction of PMAY-G House for Individuals -PMAY-G  REG. NO. WB1337249 ,04/01/2019 ,17190 ,0 ,17190 ,0 ,24/01/2018,17190,0,0,0,0  ,17190,
(3201009002/IF/IAY/4117676),Construction of PMAY-G House for Individuals -PMAY-G  REG. NO. WB3065094 ,15/09/2021 ,19170 ,0 ,18822 ,0 ,29/06/2020,18822,0,0,0,0  ,18822,
(3201009002/IF/IAY/4117667),Construction of PMAY-G House for Individuals -PMAY-G  REG. NO. WB2222080 ,15/09/2021 ,19170 ,0 ,18822 ,0 ,26/06/2020,18822,0,0,0,0  ,18822,
(3201009002/IF/IAY/4117750),Construction of PMAY-G House for Individuals -PMAY-G  REG. NO. WB1582342 ,15/09/2021 ,19170 ,0 ,18822 ,0 ,24/06/2020,18822,0,0,0,0  ,18822,
(3201009002/IF/IAY/4117654),Construction of PMAY-G House for Individuals -PMAY-G  REG. NO. WB3053521 ,15/09/2021 ,19170 ,0 ,18822 ,0 ,06/07/2020,18822,0,0,0,0  ,18822,
(3201009002/IF/IAY/4117681),Construction of PMAY-G House for Individuals -PMAY-G  REG. NO. WB3047709 ,15/09/2021 ,19170 ,0 ,18822 ,0 ,29/06/2020,18822,0,0,0,0  ,18822,
(3201009002/IF/IAY/2149829),Construction of PMAY-G House for Individuals -PMAY-G  REG. NO. WB3829472 ,08/01/2019 ,17190 ,0 ,17190 ,0 ,12/02/2018,17190,0,0,0,0  ,17190,
(3201009002/IF/IAY/2150730),Construction of PMAY-G House for Individuals -PMAY-G  REG. NO. WB3314749 ,29/12/2018 ,17190 ,0 ,17190 ,0 ,12/02/2018,17190,0,0,0,0  ,17190,
(3201009002/IF/IAY/4117713),Construction of PMAY-G House for Individuals -PMAY-G  REG. NO. WB1945757 ,15/09/2021 ,19170 ,0 ,18822 ,0 ,10/06/2020,18822,0,0,0,0  ,18822,
(3201009002/IF/IAY/4117663),Construction of PMAY-G House for Individuals -PMAY-G  REG. NO. WB2573653 ,15/09/2021 ,19170 ,0 ,18822 ,0 ,24/06/2020,18822,0,0,0,0  ,18822,
(3201009002/IF/IAY/2147729),Construction of PMAY-G House for Individuals -PMAY-G  REG. NO. WB2827479 ,08/01/2019 ,17190 ,0 ,17190 ,0 ,21/02/2018,17190,0,0,0,0  ,17190,
(3201009002/IF/IAY/2148618),Construction of PMAY-G House for Individuals -PMAY-G  REG. NO. WB3309887 ,08/01/2019 ,17190 ,0 ,17190 ,0 ,24/01/2018,17190,0,0,0,0  ,17190,
(3201009002/IF/IAY/2153542),Construction of PMAY-G House for Individuals -PMAY-G  REG. NO. WB3626967 ,19/11/2018 ,17190 ,0 ,17190 ,0 ,24/01/2018,17190,0,0,0,0  ,17190,
(3201009002/IF/IAY/2147485),Construction of PMAY-G House for Individuals -PMAY-G  REG. NO. WB1488931 ,22/01/2019 ,17190 ,0 ,17190 ,0 ,12/02/2018,17190,0,0,0,0  ,17190,
(3201009002/IF/IAY/2147671),Construction of PMAY-G House for Individuals -PMAY-G  REG. NO. WB3830395 ,19/11/2018 ,17190 ,0 ,17190 ,0 ,24/01/2018,17190,0,0,0,0  ,17190,
(3201009002/IF/IAY/2147488),Construction of PMAY-G House for Individuals -PMAY-G  REG. NO. WB2597642 ,29/12/2018 ,17190 ,0 ,17190 ,0 ,12/02/2018,17190,0,0,0,0  ,17190,
(3201009002/IF/IAY/4117641),Construction of PMAY-G House for Individuals -PMAY-G  REG. NO. WB1680053 ,15/09/2021 ,19170 ,0 ,18822 ,0 ,26/06/2020,18822,0,0,0,0  ,18822,
(3201009002/IF/IAY/4117642),Construction of PMAY-G House for Individuals -PMAY-G  REG. NO. WB2364908 ,15/09/2021 ,19170 ,0 ,18822 ,0 ,29/06/2020,18822,0,0,0,0  ,18822,
(3201009002/IF/IAY/4117643),Construction of PMAY-G House for Individuals -PMAY-G  REG. NO. WB3000820 ,15/09/2021 ,19170 ,0 ,18822 ,0 ,10/06/2020,18822,0,0,0,0  ,18822,
(3201009002/IF/IAY/2154826),Construction of PMAY-G House for Individuals -PMAY-G  REG. NO. WB3248936 ,29/12/2018 ,17190 ,0 ,17190 ,0 ,24/01/2018,17190,0,0,0,0  ,17190,
(3201009002/IF/IAY/2146786),Construction of PMAY-G House for Individuals -PMAY-G  REG. NO. WB1511509 ,22/01/2019 ,17190 ,0 ,17190 ,0 ,12/02/2018,17190,0,0,0,0  ,17190,
(3201009002/IF/IAY/4117637),Construction of PMAY-G House for Individuals -PMAY-G  REG. NO. WB1642872 ,15/09/2021 ,19170 ,0 ,18822 ,0 ,24/06/2020,18822,0,0,0,0  ,18822,
(3201009002/IF/IAY/2146342),Construction of PMAY-G House for Individuals -PMAY-G  REG. NO. WB3323064 ,29/12/2018 ,17190 ,0 ,17190 ,0 ,12/02/2018,17190,0,0,0,0  ,17190,
(3201009002/IF/IAY/2151186),Construction of PMAY-G House for Individuals -PMAY-G  REG. NO. WB1470965 ,19/12/2018 ,17190 ,0 ,17190 ,0 ,24/01/2018,17190,0,0,0,0  ,17190,
(3201009002/IF/IAY/2161064),Construction of PMAY-G House for Individuals -PMAY-G  REG. NO. WB3824570 ,29/12/2018 ,17190 ,0 ,17190 ,0 ,12/02/2018,17190,0,0,0,0  ,17190,
(3201009002/IF/IAY/2144954),Construction of PMAY-G House for Individuals -PMAY-G  REG. NO. WB3827322 ,22/01/2019 ,17190 ,0 ,17190 ,0 ,12/02/2018,17190,0,0,0,0  ,17190,
(3201009002/IF/IAY/2145972),Construction of PMAY-G House for Individuals -PMAY-G  REG. NO. WB3318244 ,04/01/2019 ,17190 ,0 ,17190 ,0 ,12/02/2018,17190,0,0,0,0  ,17190,
(3201009002/IF/IAY/2145778),Construction of PMAY-G House for Individuals -PMAY-G  REG. NO. WB2593766 ,04/01/2019 ,17190 ,0 ,17190 ,0 ,24/01/2018,17190,0,0,0,0  ,17190,
(3201009002/IF/IAY/2147001),Construction of PMAY-G House for Individuals -PMAY-G  REG. NO. WB3248998 ,29/12/2018 ,17190 ,0 ,17190 ,0 ,12/02/2018,17190,0,0,0,0  ,17190,
(3201009002/IF/IAY/4117626),Construction of PMAY-G House for Individuals -PMAY-G  REG. NO. WB2722906 ,15/09/2021 ,19170 ,0 ,18822 ,0 ,10/06/2020,18822,0,0,0,0  ,18822,
(3201009002/IF/IAY/4117632),Construction of PMAY-G House for Individuals -PMAY-G  REG. NO. WB2176513 ,30/08/2021 ,19170 ,0 ,18822 ,0 ,29/06/2020,18822,0,0,0,0  ,18822,
(3201009002/IF/IAY/4117602),Construction of PMAY-G House for Individuals -PMAY-G  REG. NO. WB3395526 ,15/09/2021 ,19170 ,0 ,18822 ,0 ,29/06/2020,18822,0,0,0,0  ,18822,
(3201009002/IF/IAY/4117620),Construction of PMAY-G House for Individuals -PMAY-G  REG. NO. WB2172614 ,15/09/2021 ,19170 ,0 ,18609 ,0 ,24/06/2020,18609,0,0,0,0  ,18609,
(3201009002/IF/IAY/2144688),Construction of PMAY-G House for Individuals -PMAY-G  REG. NO. WB3272673 ,29/12/2018 ,17190 ,0 ,17190 ,0 ,12/02/2018,17190,0,0,0,0  ,17190,
(3201009002/IF/IAY/4117583),Construction of PMAY-G House for Individuals -PMAY-G  REG. NO. WB2172780 ,15/09/2021 ,19170 ,0 ,18822 ,0 ,24/06/2020,18822,0,0,0,0  ,18822,
(3201009002/IF/IAY/2145069),Construction of PMAY-G House for Individuals -PMAY-G  REG. NO. WB2162404 ,19/12/2018 ,17190 ,0 ,17190 ,0 ,24/01/2018,17190,0,0,0,0  ,17190,
(3201009002/IF/IAY/2144532),Construction of PMAY-G House for Individuals -PMAY-G  REG. NO. WB2734496 ,29/12/2018 ,17190 ,0 ,17190 ,0 ,21/02/2018,17190,0,0,0,0  ,17190,
(3201009002/IF/IAY/2144949),Construction of PMAY-G House for Individuals -PMAY-G  REG. NO. WB2694342 ,26/10/2018 ,17190 ,0 ,17190 ,0 ,12/02/2018,17190,0,0,0,0  ,17190,
(3201009002/IF/IAY/2143724),Construction of PMAY-G House for Individuals -PMAY-G  REG. NO. WB3318055 ,04/01/2019 ,17190 ,0 ,17190 ,0 ,12/02/2018,17190,0,0,0,0  ,17190,
(3201009002/IF/IAY/4117523),Construction of PMAY-G House for Individuals -PMAY-G  REG. NO. WB2785480 ,30/08/2021 ,19170 ,0 ,18822 ,0 ,10/06/2020,18822,0,0,0,0  ,18822,
(3201009002/IF/IAY/4117538),Construction of PMAY-G House for Individuals -PMAY-G  REG. NO. WB3029838 ,15/09/2021 ,19170 ,0 ,18822 ,0 ,29/06/2020,18822,0,0,0,0  ,18822,
(3201009002/IF/IAY/2144369),Construction of PMAY-G House for Individuals -PMAY-G  REG. NO. WB3249019 ,29/12/2018 ,17190 ,0 ,17190 ,0 ,12/02/2018,17190,0,0,0,0  ,17190,
(3201009002/IF/IAY/4116831),Construction of PMAY-G House for Individuals -PMAY-G  REG. NO. WB1640388 ,15/09/2021 ,19170 ,0 ,18822 ,0 ,10/06/2020,18822,0,0,0,0  ,18822,
(3201009002/IF/IAY/4116840),Construction of PMAY-G House for Individuals -PMAY-G  REG. NO. WB2370504 ,15/09/2021 ,19170 ,0 ,18822 ,0 ,06/07/2020,18822,0,0,0,0  ,18822,
(3201009002/IF/IAY/2143608),Construction of PMAY-G House for Individuals -PMAY-G  REG. NO. WB3308633 ,04/01/2019 ,17190 ,0 ,17190 ,0 ,12/02/2018,17190,0,0,0,0  ,17190,
(3201009002/IF/IAY/2143491),Construction of PMAY-G House for Individuals -PMAY-G  REG. NO. WB1553747 ,08/01/2019 ,17190 ,0 ,17190 ,0 ,21/02/2018,17190,0,0,0,0  ,17190,
(3201009002/IF/IAY/2143391),Construction of PMAY-G House for Individuals -PMAY-G  REG. NO. WB3293256 ,29/12/2018 ,17190 ,0 ,17190 ,0 ,12/02/2018,17190,0,0,0,0  ,17190,
(3201009002/IF/IAY/2146546),Construction of PMAY-G House for Individuals -PMAY-G  REG. NO. WB1538118 ,08/01/2019 ,17190 ,0 ,17190 ,0 ,21/02/2018,17190,0,0,0,0  ,17190,
(3201009002/IF/IAY/2143332),Construction of PMAY-G House for Individuals -PMAY-G  REG. NO. WB3320690 ,04/01/2019 ,17190 ,0 ,17190 ,0 ,12/02/2018,17190,0,0,0,0  ,17190,
(3201009002/IF/IAY/2143488),Construction of PMAY-G House for Individuals -PMAY-G  REG. NO. WB3613314 ,19/12/2018 ,17190 ,0 ,17190 ,0 ,24/01/2018,17190,0,0,0,0  ,17190,
(3201009002/IF/IAY/4116829),Construction of PMAY-G House for Individuals -PMAY-G  REG. NO. WB3173109 ,15/09/2021 ,19170 ,0 ,18822 ,0 ,06/07/2020,18822,0,0,0,0  ,18822,
(3201009002/IF/IAY/4116839),Construction of PMAY-G House for Individuals -PMAY-G  REG. NO. WB1624469 ,15/09/2021 ,19170 ,0 ,18822 ,0 ,24/06/2020,18822,0,0,0,0  ,18822,
(3201009002/IF/IAY/2144563),Construction of PMAY-G House for Individuals -PMAY-G  REG. NO. WB1949705 ,08/01/2019 ,17190 ,0 ,17190 ,0 ,12/02/2018,17190,0,0,0,0  ,17190,
(3201009002/IF/IAY/2143127),Construction of PMAY-G House for Individuals -PMAY-G  REG. NO. WB1679257 ,08/01/2019 ,17190 ,0 ,17190 ,0 ,21/02/2018,17190,0,0,0,0  ,17190,
(3201009002/IF/IAY/4116808),Construction of PMAY-G House for Individuals -PMAY-G  REG. NO. WB1582365 ,15/09/2021 ,19170 ,0 ,18822 ,0 ,24/06/2020,18822,0,0,0,0  ,18822,
(3201009002/IF/IAY/2147044),Construction of PMAY-G House for Individuals -PMAY-G  REG. NO. WB2824267 ,19/12/2018 ,17190 ,0 ,17190 ,0 ,24/01/2018,17190,0,0,0,0  ,17190,
(3201009002/IF/IAY/4117630),Construction of PMAY-G House for Individuals -PMAY-G  REG. NO. WB2785810 ,15/09/2021 ,19170 ,0 ,18822 ,0 ,10/06/2020,18822,0,0,0,0  ,18822,
(3201009002/IF/IAY/4116777),Construction of PMAY-G House for Individuals -PMAY-G  REG. NO. WB2199941 ,15/09/2021 ,19170 ,0 ,18822 ,0 ,10/06/2020,18822,0,0,0,0  ,18822,
(3201009002/IF/IAY/4116815),Construction of PMAY-G House for Individuals -PMAY-G  REG. NO. WB2034889 ,15/09/2021 ,19170 ,0 ,18822 ,0 ,26/06/2020,18822,0,0,0,0  ,18822,
(3201009002/IF/IAY/4116770),Construction of PMAY-G House for Individuals -PMAY-G  REG. NO. WB1633889 ,15/09/2021 ,19170 ,0 ,18822 ,0 ,10/06/2020,18822,0,0,0,0  ,18822,
(3201009002/IF/IAY/4116805),Construction of PMAY-G House for Individuals -PMAY-G  REG. NO. WB3149906 ,15/09/2021 ,19170 ,0 ,18822 ,0 ,24/06/2020,18822,0,0,0,0  ,18822,
(3201009002/IF/IAY/2142806),Construction of PMAY-G House for Individuals -PMAY-G  REG. NO. WB2868516 ,19/12/2018 ,17190 ,0 ,17190 ,0 ,24/01/2018,17190,0,0,0,0  ,17190,
(3201009002/IF/IAY/4116812),Construction of PMAY-G House for Individuals -PMAY-G  REG. NO. WB2570944 ,15/09/2021 ,19170 ,0 ,18822 ,0 ,26/06/2020,18822,0,0,0,0  ,18822,
(3201009002/IF/IAY/2149133),Construction of PMAY-G House for Individuals -PMAY-G  REG. NO. WB1482923 ,19/12/2018 ,17190 ,0 ,17190 ,0 ,12/02/2018,17190,0,0,0,0  ,17190,
(3201009002/IF/IAY/4116788),Construction of PMAY-G House for Individuals -PMAY-G  REG. NO. WB2177163 ,15/09/2021 ,19170 ,0 ,18822 ,0 ,24/06/2020,18822,0,0,0,0  ,18822,
(3201009002/IF/IAY/4116756),Construction of PMAY-G House for Individuals -PMAY-G  REG. NO. WB2197201 ,15/09/2021 ,19170 ,0 ,18822 ,0 ,24/06/2020,18822,0,0,0,0  ,18822,
(3201009002/IF/IAY/2142378),Construction of PMAY-G House for Individuals -PMAY-G  REG. NO. WB3292382 ,08/01/2019 ,17190 ,0 ,17190 ,0 ,12/02/2018,17190,0,0,0,0  ,17190,
(3201009002/IF/IAY/2142475),Construction of PMAY-G House for Individuals -PMAY-G  REG. NO. WB3861742 ,08/01/2019 ,17190 ,0 ,17190 ,0 ,24/01/2018,17190,0,0,0,0  ,17190,
(3201009002/IF/IAY/2142624),Construction of PMAY-G House for Individuals -PMAY-G  REG. NO. WB2667956 ,08/01/2019 ,17190 ,0 ,17190 ,0 ,24/01/2018,17190,0,0,0,0  ,17190,
(3201009002/IF/IAY/4116751),Construction of PMAY-G House for Individuals -PMAY-G  REG. NO. WB2168304 ,15/09/2021 ,19170 ,0 ,18822 ,0 ,26/06/2020,18822,0,0,0,0  ,18822,
(3201009002/IF/IAY/4116748),Construction of PMAY-G House for Individuals -PMAY-G  REG. NO. WB2172954 ,15/09/2021 ,19170 ,0 ,18822 ,0 ,24/06/2020,18822,0,0,0,0  ,18822,
(3201009002/IF/IAY/4116732),Construction of PMAY-G House for Individuals -PMAY-G  REG. NO. WB3064573 ,15/09/2021 ,19170 ,0 ,18822 ,0 ,29/06/2020,18822,0,0,0,0  ,18822,
(3201009002/IF/IAY/4116776),Construction of PMAY-G House for Individuals -PMAY-G  REG. NO. WB3039499 ,15/09/2021 ,19170 ,0 ,18822 ,0 ,29/06/2020,18822,0,0,0,0  ,18822,
(3201009002/IF/IAY/4116738),Construction of PMAY-G House for Individuals -PMAY-G  REG. NO. WB1602076 ,15/09/2021 ,19170 ,0 ,18822 ,0 ,26/06/2020,18822,0,0,0,0  ,18822,
(3201009002/IF/IAY/4116800),Construction of PMAY-G House for Individuals -PMAY-G  REG. NO. WB2557079 ,15/09/2021 ,19170 ,0 ,18822 ,0 ,24/06/2020,18822,0,0,0,0  ,18822,
(3201009002/IF/IAY/4116683),Construction of PMAY-G House for Individuals -PMAY-G  REG. NO. WB3429769 ,15/09/2021 ,19170 ,0 ,18609 ,0 ,29/06/2020,18609,0,0,0,0  ,18609,
(3201009002/IF/IAY/4116697),Construction of PMAY-G House for Individuals -PMAY-G  REG. NO. WB2177117 ,15/09/2021 ,19170 ,0 ,18822 ,0 ,24/06/2020,18822,0,0,0,0  ,18822,
(3201009002/IF/IAY/4116736),Construction of PMAY-G House for Individuals -PMAY-G  REG. NO. WB1645442 ,15/09/2021 ,19170 ,0 ,18822 ,0 ,26/06/2020,18822,0,0,0,0  ,18822,
(3201009002/IF/IAY/2140054),Construction of PMAY-G House for Individuals -PMAY-G  REG. NO. WB3258018 ,26/10/2018 ,17190 ,0 ,17190 ,0 ,12/02/2018,17190,0,0,0,0  ,17190,
(3201009002/IF/IAY/4116742),Construction of PMAY-G House for Individuals -PMAY-G  REG. NO. WB1663066 ,15/09/2021 ,19170 ,0 ,18822 ,0 ,10/06/2020,18822,0,0,0,0  ,18822,
(3201009002/IF/IAY/2139851),Construction of PMAY-G House for Individuals -PMAY-G  REG. NO. WB1487968 ,08/01/2019 ,17190 ,0 ,17190 ,0 ,12/02/2018,17190,0,0,0,0  ,17190,
(3201009002/IF/IAY/2139876),Construction of PMAY-G House for Individuals -PMAY-G  REG. NO. WB3796866 ,01/11/2018 ,17190 ,0 ,17190 ,0 ,12/02/2018,17190,0,0,0,0  ,17190,
(3201009002/IF/IAY/2139707),Construction of PMAY-G House for Individuals -PMAY-G  REG. NO. WB2107836 ,08/01/2019 ,17190 ,0 ,17190 ,0 ,24/01/2018,17190,0,0,0,0  ,17190,
(3201009002/IF/IAY/2140730),Construction of PMAY-G House for Individuals -PMAY-G  REG. NO. WB3607732 ,19/12/2018 ,17190 ,0 ,17190 ,0 ,24/01/2018,17190,0,0,0,0  ,17190,
(3201009002/IF/IAY/2142398),Construction of PMAY-G House for Individuals -PMAY-G  REG. NO. WB1528469 ,08/01/2019 ,17190 ,0 ,17190 ,0 ,21/02/2018,17190,0,0,0,0  ,17190,
(3201009002/IF/IAY/2138246),Construction of PMAY-G House for Individuals -PMAY-G  REG. NO. WB1509059 ,08/01/2019 ,17190 ,0 ,17190 ,0 ,12/02/2018,17190,0,0,0,0  ,17190,
(3201009002/IF/IAY/2139260),Construction of PMAY-G House for Individuals -PMAY-G  REG. NO. WB2143000 ,08/01/2019 ,17190 ,0 ,17190 ,0 ,12/02/2018,17190,0,0,0,0  ,17190,
(3201009002/IF/IAY/2139990),Construction of PMAY-G House for Individuals -PMAY-G  REG. NO. WB2358238 ,19/12/2018 ,17190 ,0 ,17190 ,0 ,12/02/2018,17190,0,0,0,0  ,17190,
(3201009002/IF/IAY/4116673),Construction of PMAY-G House for Individuals -PMAY-G  REG. NO. WB1645449 ,15/09/2021 ,19170 ,0 ,15972 ,0 ,26/06/2020,15972,0,0,0,0  ,15972,
(3201009002/IF/IAY/4116670),Construction of PMAY-G House for Individuals -PMAY-G  REG. NO. WB1659166 ,15/09/2021 ,19170 ,0 ,18822 ,0 ,10/06/2020,18822,0,0,0,0  ,18822,
(3201009002/IF/IAY/4116752),Construction of PMAY-G House for Individuals -PMAY-G  REG. NO. WB3105080 ,15/09/2021 ,19170 ,0 ,18822 ,0 ,29/06/2020,18822,0,0,0,0  ,18822,
(3201009002/IF/IAY/4116677),Construction of PMAY-G House for Individuals -PMAY-G  REG. NO. WB1602778 ,15/09/2021 ,19170 ,0 ,18822 ,0 ,10/06/2020,18822,0,0,0,0  ,18822,
(3201009002/IF/IAY/4116680),Construction of PMAY-G House for Individuals -PMAY-G  REG. NO. WB2223746 ,15/09/2021 ,19170 ,0 ,18609 ,0 ,06/07/2020,18609,0,0,0,0  ,18609,
(3201009002/IF/IAY/4116642),Construction of PMAY-G House for Individuals -PMAY-G  REG. NO. WB1623486 ,15/09/2021 ,19170 ,0 ,18822 ,0 ,10/06/2020,18822,0,0,0,0  ,18822,
(3201009002/IF/IAY/4116641),Construction of PMAY-G House for Individuals -PMAY-G  REG. NO. WB3437770 ,15/09/2021 ,19170 ,0 ,18822 ,0 ,06/07/2020,18822,0,0,0,0  ,18822,
(3201009002/IF/IAY/4116656),Construction of PMAY-G House for Individuals -PMAY-G  REG. NO. WB2224150 ,15/09/2021 ,19170 ,0 ,18822 ,0 ,26/06/2020,18822,0,0,0,0  ,18822,
(3201009002/IF/IAY/4116634),Construction of PMAY-G House for Individuals -PMAY-G  REG. NO. WB2513170 ,15/09/2021 ,19170 ,0 ,18822 ,0 ,06/07/2020,18822,0,0,0,0  ,18822,
(3201009002/IF/IAY/4116633),Construction of PMAY-G House for Individuals -PMAY-G  REG. NO. WB2176337 ,15/09/2021 ,19170 ,0 ,18822 ,0 ,24/06/2020,18822,0,0,0,0  ,18822,
(3201009002/IF/IAY/4116632),Construction of PMAY-G House for Individuals -PMAY-G  REG. NO. WB3068189 ,15/09/2021 ,19170 ,0 ,18822 ,0 ,29/06/2020,18822,0,0,0,0  ,18822,
(3201009002/IF/IAY/4116635),Construction of PMAY-G House for Individuals -PMAY-G  REG. NO. WB1680022 ,15/09/2021 ,19170 ,0 ,18822 ,0 ,26/06/2020,18822,0,0,0,0  ,18822,
(3201009002/IF/IAY/4116652),Construction of PMAY-G House for Individuals -PMAY-G  REG. NO. WB3258837 ,15/09/2021 ,19170 ,0 ,18822 ,0 ,06/07/2020,18822,0,0,0,0  ,18822,
(3201009002/IF/IAY/2138028),Construction of PMAY-G House for Individuals -PMAY-G  REG. NO. WB3264714 ,26/10/2018 ,17190 ,0 ,17190 ,0 ,12/02/2018,17190,0,0,0,0  ,17190,
(3201009002/IF/IAY/4116654),Construction of PMAY-G House for Individuals -PMAY-G  REG. NO. WB2159588 ,15/09/2021 ,19170 ,0 ,18822 ,0 ,29/06/2020,18822,0,0,0,0  ,18822,
(3201009002/IF/IAY/2137620),Construction of PMAY-G House for Individuals -PMAY-G  REG. NO. WB2711850 ,22/01/2019 ,17190 ,0 ,17190 ,0 ,24/01/2018,17190,0,0,0,0  ,17190,
(3201009002/IF/IAY/2137214),Construction of PMAY-G House for Individuals -PMAY-G  REG. NO. WB2711237 ,26/10/2018 ,17190 ,0 ,17190 ,0 ,12/02/2018,17190,0,0,0,0  ,17190,
(3201009002/IF/IAY/2136876),Construction of PMAY-G House for Individuals -PMAY-G  REG. NO. WB1483226 ,08/01/2019 ,17190 ,0 ,17190 ,0 ,12/02/2018,17190,0,0,0,0  ,17190,
(3201009002/IF/IAY/2137713),Construction of PMAY-G House for Individuals -PMAY-G  REG. NO. WB1497669 ,19/12/2018 ,17190 ,0 ,17190 ,0 ,12/02/2018,17190,0,0,0,0  ,17190,
(3201009002/IF/IAY/2137940),Construction of PMAY-G House for Individuals -PMAY-G  REG. NO. WB3248959 ,04/01/2019 ,17190 ,0 ,17190 ,0 ,12/02/2018,17190,0,0,0,0  ,17190,
(3201009002/IF/IAY/4116620),Construction of PMAY-G House for Individuals -PMAY-G  REG. NO. WB3396213 ,15/09/2021 ,19170 ,0 ,18822 ,0 ,29/06/2020,18822,0,0,0,0  ,18822,
(3201009002/IF/IAY/4116621),Construction of PMAY-G House for Individuals -PMAY-G  REG. NO. WB3122337 ,15/09/2021 ,19170 ,0 ,18822 ,0 ,06/07/2020,18822,0,0,0,0  ,18822,
(3201009002/IF/IAY/4116630),Construction of PMAY-G House for Individuals -PMAY-G  REG. NO. WB3401225 ,15/09/2021 ,19170 ,0 ,18822 ,0 ,29/06/2020,18822,0,0,0,0  ,18822,
(3201009002/IF/IAY/4116616),Construction of PMAY-G House for Individuals -PMAY-G  REG. NO. WB3078487 ,15/09/2021 ,19170 ,0 ,18822 ,0 ,06/07/2020,18822,0,0,0,0  ,18822,
(3201009002/IF/IAY/4116686),Construction of PMAY-G House for Individuals -PMAY-G  REG. NO. WB3122199 ,15/09/2021 ,19170 ,0 ,18822 ,0 ,29/06/2020,18822,0,0,0,0  ,18822,
(3201009002/IF/IAY/4116631),Construction of PMAY-G House for Individuals -PMAY-G  REG. NO. WB3062387 ,15/09/2021 ,19170 ,0 ,18822 ,0 ,29/06/2020,18822,0,0,0,0  ,18822,
(3201009002/IF/IAY/4116611),Construction of PMAY-G House for Individuals -PMAY-G  REG. NO. WB2159432 ,15/09/2021 ,19170 ,0 ,18822 ,0 ,29/06/2020,18822,0,0,0,0  ,18822,
(3201009002/IF/IAY/4116580),Construction of PMAY-G House for Individuals -PMAY-G  REG. NO. WB2835793 ,15/09/2021 ,19170 ,0 ,18822 ,0 ,10/06/2020,18822,0,0,0,0  ,18822,
(3201009002/IF/IAY/2138179),Construction of PMAY-G House for Individuals -PMAY-G  REG. NO. WB1434199 ,19/12/2018 ,17190 ,0 ,17190 ,0 ,24/01/2018,17190,0,0,0,0  ,17190,
(3201009002/IF/IAY/4116578),Construction of PMAY-G House for Individuals -PMAY-G  REG. NO. WB2193042 ,15/09/2021 ,19170 ,0 ,18822 ,0 ,26/06/2020,18822,0,0,0,0  ,18822,
(3201009002/IF/IAY/4116601),Construction of PMAY-G House for Individuals -PMAY-G  REG. NO. WB1854107 ,15/09/2021 ,19170 ,0 ,18822 ,0 ,24/06/2020,18822,0,0,0,0  ,18822,
(3201009002/IF/IAY/4116615),Construction of PMAY-G House for Individuals -PMAY-G  REG. NO. WB2364521 ,15/09/2021 ,19170 ,0 ,18822 ,0 ,29/06/2020,18822,0,0,0,0  ,18822,
(3201009002/IF/IAY/4116572),Construction of PMAY-G House for Individuals -PMAY-G  REG. NO. WB5746294 ,15/09/2021 ,19170 ,0 ,18822 ,0 ,24/06/2020,18822,0,0,0,0  ,18822,
(3201009002/IF/IAY/4116565),Construction of PMAY-G House for Individuals -PMAY-G  REG. NO. WB3055451 ,15/09/2021 ,19170 ,0 ,18822 ,0 ,29/06/2020,18822,0,0,0,0  ,18822,
(3201009002/IF/IAY/4116548),Construction of PMAY-G House for Individuals -PMAY-G  REG. NO. WB3036495 ,15/09/2021 ,19170 ,0 ,18822 ,0 ,26/06/2020,18822,0,0,0,0  ,18822,
(3201009002/IF/IAY/4116534),Construction of PMAY-G House for Individuals -PMAY-G  REG. NO. WB2201135 ,15/09/2021 ,19170 ,0 ,18822 ,0 ,26/06/2020,18822,0,0,0,0  ,18822,
(3201009002/IF/IAY/4116570),Construction of PMAY-G House for Individuals -PMAY-G  REG. NO. WB2587431 ,15/09/2021 ,19170 ,0 ,18822 ,0 ,29/06/2020,18822,0,0,0,0  ,18822,
(3201009002/IF/IAY/4116567),Construction of PMAY-G House for Individuals -PMAY-G  REG. NO. WB2556775 ,15/09/2021 ,19170 ,0 ,18822 ,0 ,29/06/2020,18822,0,0,0,0  ,18822,
(3201009002/IF/IAY/4116592),Construction of PMAY-G House for Individuals -PMAY-G  REG. NO. WB2152840 ,15/09/2021 ,19170 ,0 ,18609 ,0 ,26/06/2020,18609,0,0,0,0  ,18609,
(3201009002/IF/IAY/4116545),Construction of PMAY-G House for Individuals -PMAY-G  REG. NO. WB2421449 ,15/09/2021 ,19170 ,0 ,18822 ,0 ,29/06/2020,18822,0,0,0,0  ,18822,
(3201009002/IF/IAY/2140028),Construction of PMAY-G House for Individuals -PMAY-G  REG. NO. WB3248432 ,04/01/2019 ,17190 ,0 ,17190 ,0 ,24/01/2018,17190,0,0,0,0  ,17190,
(3201009002/IF/IAY/4116525),Construction of PMAY-G House for Individuals -PMAY-G  REG. NO. WB2228275 ,15/09/2021 ,19170 ,0 ,18822 ,0 ,29/06/2020,18822,0,0,0,0  ,18822,
(3201009002/IF/IAY/2136101),Construction of PMAY-G House for Individuals -PMAY-G  REG. NO. WB1451303 ,22/01/2019 ,17190 ,0 ,17190 ,0 ,24/01/2018,17190,0,0,0,0  ,17190,
(3201009002/IF/IAY/2136590),Construction of PMAY-G House for Individuals -PMAY-G  REG. NO. WB3315901 ,26/10/2018 ,17190 ,0 ,17190 ,0 ,12/02/2018,17190,0,0,0,0  ,17190,
(3201009002/IF/IAY/2135210),Construction of PMAY-G House for Individuals -PMAY-G  REG. NO. WB3305742 ,04/01/2019 ,17190 ,0 ,17190 ,0 ,12/02/2018,17190,0,0,0,0  ,17190,
(3201009002/IF/IAY/4116610),Construction of PMAY-G House for Individuals -PMAY-G  REG. NO. WB2225086 ,15/09/2021 ,19170 ,0 ,18822 ,0 ,26/06/2020,18822,0,0,0,0  ,18822,
(3201009002/IF/IAY/2136670),Construction of PMAY-G House for Individuals -PMAY-G  REG. NO. WB3248345 ,04/01/2019 ,17190 ,0 ,17190 ,0 ,24/01/2018,17190,0,0,0,0  ,17190,
(3201009002/IF/IAY/2135294),Construction of PMAY-G House for Individuals -PMAY-G  REG. NO. WB1542225 ,08/01/2019 ,17190 ,0 ,17190 ,0 ,21/02/2018,17190,0,0,0,0  ,17190,
(3201009002/IF/IAY/2134071),Construction of PMAY-G House for Individuals -PMAY-G  REG. NO. WB1468423 ,22/01/2019 ,17190 ,0 ,17190 ,0 ,12/02/2018,17190,0,0,0,0  ,17190,
(3201009002/IF/IAY/2134732),Construction of PMAY-G House for Individuals -PMAY-G  REG. NO. WB3315715 ,26/10/2018 ,17190 ,0 ,17190 ,0 ,24/01/2018,17190,0,0,0,0  ,17190,
(3201009002/IF/IAY/2133675),Construction of PMAY-G House for Individuals -PMAY-G  REG. NO. WB3321569 ,29/12/2018 ,17190 ,0 ,17190 ,0 ,12/02/2018,17190,0,0,0,0  ,17190,
(3201009002/IF/IAY/2136412),Construction of PMAY-G House for Individuals -PMAY-G  REG. NO. WB1475825 ,19/12/2018 ,17190 ,0 ,17190 ,0 ,12/02/2018,17190,0,0,0,0  ,17190,
(3201009002/IF/IAY/2133596),Construction of PMAY-G House for Individuals -PMAY-G  REG. NO. WB1493130 ,22/01/2019 ,17190 ,0 ,17190 ,0 ,12/02/2018,17190,0,0,0,0  ,17190,
(3201009002/IF/IAY/2134865),Construction of PMAY-G House for Individuals -PMAY-G  REG. NO. WB1515490 ,19/12/2018 ,17190 ,0 ,17190 ,0 ,12/02/2018,17190,0,0,0,0  ,17190,
(3201009002/IF/IAY/4116516),Construction of PMAY-G House for Individuals -PMAY-G  REG. NO. WB2370542 ,15/09/2021 ,19170 ,0 ,18822 ,0 ,06/07/2020,18822,0,0,0,0  ,18822,
(3201009002/IF/IAY/2133997),Construction of PMAY-G House for Individuals -PMAY-G  REG. NO. WB1483693 ,22/01/2019 ,17190 ,0 ,17190 ,0 ,12/02/2018,17190,0,0,0,0  ,17190,
(3201009002/IF/IAY/4116504),Construction of PMAY-G House for Individuals -PMAY-G  REG. NO. WB2091239 ,15/09/2021 ,19170 ,0 ,18822 ,0 ,26/06/2020,18822,0,0,0,0  ,18822,
(3201009002/IF/IAY/2133404),Construction of PMAY-G House for Individuals -PMAY-G  REG. NO. WB1475457 ,19/12/2018 ,17190 ,0 ,17190 ,0 ,24/01/2018,17190,0,0,0,0  ,17190,
(3201009002/IF/IAY/4116490),Construction of PMAY-G House for Individuals -PMAY-G  REG. NO. WB3313521 ,15/09/2021 ,19170 ,0 ,18822 ,0 ,24/06/2020,18822,0,0,0,0  ,18822,
(3201009002/IF/IAY/4116499),Construction of PMAY-G House for Individuals -PMAY-G  REG. NO. WB2200364 ,15/09/2021 ,19170 ,0 ,18822 ,0 ,29/06/2020,18822,0,0,0,0  ,18822,
(3201009002/IF/IAY/2138434),Construction of PMAY-G House for Individuals -PMAY-G  REG. NO. WB3294727 ,29/12/2018 ,17190 ,0 ,17190 ,0 ,12/02/2018,17190,0,0,0,0  ,17190,
(3201009002/IF/IAY/4116489),Construction of PMAY-G House for Individuals -PMAY-G  REG. NO. WB2226634 ,15/09/2021 ,19170 ,0 ,18822 ,0 ,26/06/2020,18822,0,0,0,0  ,18822,
(3201009002/IF/IAY/2136189),Construction of PMAY-G House for Individuals -PMAY-G  REG. NO. WB3577321 ,19/12/2018 ,17190 ,0 ,17190 ,0 ,24/01/2018,17190,0,0,0,0  ,17190,
(3201009002/IF/IAY/4116462),Construction of PMAY-G House for Individuals -PMAY-G  REG. NO. WB3039374 ,15/09/2021 ,19170 ,0 ,18822 ,0 ,26/06/2020,18822,0,0,0,0  ,18822,
(3201009002/IF/IAY/4116483),Construction of PMAY-G House for Individuals -PMAY-G  REG. NO. WB3271243 ,15/09/2021 ,19170 ,0 ,18822 ,0 ,06/07/2020,18822,0,0,0,0  ,18822,
(3201009002/IF/IAY/4116478),Construction of PMAY-G House for Individuals -PMAY-G  REG. NO. WB3413705 ,15/09/2021 ,19170 ,0 ,18822 ,0 ,29/06/2020,18822,0,0,0,0  ,18822,
(3201009002/IF/IAY/4116454),Construction of PMAY-G House for Individuals -PMAY-G  REG. NO. WB2225389 ,15/09/2021 ,19170 ,0 ,18822 ,0 ,26/06/2020,18822,0,0,0,0  ,18822,
(3201009002/IF/IAY/2134258),Construction of PMAY-G House for Individuals -PMAY-G  REG. NO. WB2130769 ,19/12/2018 ,17190 ,0 ,17190 ,0 ,24/01/2018,17190,0,0,0,0  ,17190,
(3201009002/IF/IAY/4116443),Construction of PMAY-G House for Individuals -PMAY-G  REG. NO. WB3064200 ,15/09/2021 ,19170 ,0 ,18822 ,0 ,06/07/2020,18822,0,0,0,0  ,18822,
(3201009002/IF/IAY/4116459),Construction of PMAY-G House for Individuals -PMAY-G  REG. NO. WB1603007 ,15/09/2021 ,19170 ,0 ,18822 ,0 ,10/06/2020,18822,0,0,0,0  ,18822,
(3201009002/IF/IAY/4116439),Construction of PMAY-G House for Individuals -PMAY-G  REG. NO. WB2222656 ,15/09/2021 ,19170 ,0 ,18822 ,0 ,06/07/2020,18822,0,0,0,0  ,18822,
(3201009002/IF/IAY/3723018),Construction of PMAY-G House for Individuals -PMAY-G  REG. NO. WB4903795 ,19/09/2021 ,19170 ,0 ,17593 ,0 ,24/02/2020,17593,0,0,0,0  ,17593,
(3201009002/IF/IAY/4116461),Construction of PMAY-G House for Individuals -PMAY-G  REG. NO. WB3047676 ,15/09/2021 ,19170 ,0 ,18822 ,0 ,29/06/2020,18822,0,0,0,0  ,18822,
(3201009002/IF/IAY/3723017),Construction of PMAY-G House for Individuals -PMAY-G  REG. NO. WB3172688 ,19/09/2021 ,18360 ,0 ,17593 ,0 ,24/02/2020,17593,0,0,0,0  ,17593,
(3201009002/IF/IAY/4116509),Construction of PMAY-G House for Individuals -PMAY-G  REG. NO. WB3065184 ,15/09/2021 ,19170 ,0 ,18822 ,0 ,24/06/2020,18822,0,0,0,0  ,18822,
(3201009002/IF/IAY/3723016),Construction of PMAY-G House for Individuals -PMAY-G  REG. NO. WB3310722 ,17/09/2021 ,19170 ,0 ,17593 ,0 ,24/02/2020,17593,0,0,0,0  ,17593,
(3201009002/IF/IAY/3375968),Construction of PMAY-G House for Individuals -PMAY-G  REG. NO. WB3305147 ,17/09/2021 ,19170 ,0 ,16734 ,0 ,15/01/2020,16734,0,0,0,0  ,16734,
(3201009002/IF/IAY/3723014),Construction of PMAY-G House for Individuals -PMAY-G  REG. NO. WB3294515 ,17/09/2021 ,19170 ,0 ,17775 ,0 ,24/02/2020,17775,0,0,0,0  ,17775,
(3201009002/IF/IAY/3723015),Construction of PMAY-G House for Individuals -PMAY-G  REG. NO. WB3124474 ,17/09/2021 ,19170 ,0 ,17593 ,0 ,24/02/2020,17593,0,0,0,0  ,17593,
(3201009002/IF/IAY/2133049),Construction of PMAY-G House for Individuals -PMAY-G  REG. NO. WB2709067 ,22/01/2019 ,17190 ,0 ,17190 ,0 ,12/02/2018,17190,0,0,0,0  ,17190,
(3201009002/IF/IAY/2133227),Construction of PMAY-G House for Individuals -PMAY-G  REG. NO. WB3320712 ,29/12/2018 ,17190 ,0 ,17190 ,0 ,12/02/2018,17190,0,0,0,0  ,17190,
(3201009002/IF/IAY/2132382),Construction of PMAY-G House for Individuals -PMAY-G  REG. NO. WB3686409 ,19/11/2018 ,17190 ,0 ,17190 ,0 ,24/01/2018,17190,0,0,0,0  ,17190,
(3201009002/IF/IAY/2122959),Construction of PMAY-G House for Individuals -PMAY-G  REG. NO. WB5104074 ,19/11/2018 ,17190 ,0 ,17190 ,0 ,24/01/2018,17190,0,0,0,0  ,17190,
(3201009002/IF/IAY/2132747),Construction of PMAY-G House for Individuals -PMAY-G  REG. NO. WB3769742 ,22/01/2019 ,17190 ,0 ,17190 ,0 ,12/02/2018,17190,0,0,0,0  ,17190,
(3201009002/IF/IAY/1623270),Construction of IAY House -IAY REG. NO. WB2283348 ,02/07/2018 ,16200 ,0 ,16020 ,0 ,13/08/2017,16020,0,0,0,0  ,16020,
(3201009002/IF/IAY/1623570),Construction of IAY House -IAY REG. NO. WB2317174 ,02/07/2018 ,16200 ,0 ,16020 ,0 ,13/08/2017,16020,0,0,0,0  ,16020,
(3201009002/IF/IAY/1623238),Construction of IAY House -IAY REG. NO. WB2280180 ,02/07/2018 ,16200 ,0 ,16020 ,0 ,07/08/2017,16020,0,0,0,0  ,16020,
(3201009002/WC/321002040885415),EXCAVATION OF FARM POND OF ABU HANIF SEKH AT ANANDABAS. ,29/07/2020 ,337043.93 ,3000 ,280040 ,11265 ,17/02/2020,280040,0,8269,2996,0  ,291305,
(3201009002/WC/321002040884933),Excavation of farm Pond on The L/O Netai das. ,14/05/2020 ,245825.64 ,3000 ,205355 ,9185 ,17/02/2020,205355,0,6189,2996,0  ,214540,
(3201009002/IF/IAY/952489),Construction of IAY House -IAY REG. NO. WB1193135 ,10/08/2020 ,15840 ,0 ,14964 ,0 ,28/01/2017,14964,0,0,0,0  ,14964,
(3201009002/IF/IAY/3723019),Construction of PMAY-G House for Individuals -PMAY-G  REG. NO. WB3249033 ,19/09/2021 ,19170 ,0 ,17593 ,0 ,24/02/2020,17593,0,0,0,0  ,17593,
(3201009002/IF/IAY/3375992),Construction of PMAY-G House for Individuals -PMAY-G  REG. NO. WB3047649 ,30/10/2020 ,17190 ,0 ,17385 ,0 ,15/01/2020,17385,0,0,0,0  ,17385,
(3201009002/IF/IAY/4116467),Construction of PMAY-G House for Individuals -PMAY-G  REG. NO. WB3289743 ,27/08/2021 ,19170 ,0 ,19170 ,0 ,29/06/2020,19170,0,0,0,0  ,19170,
(3201009002/IF/IAY/3375974),Construction of PMAY-G House for Individuals -PMAY-G  REG. NO. WB4857342 ,20/10/2020 ,17190 ,0 ,17385 ,0 ,15/01/2020,17385,0,0,0,0  ,17385,
(3201009002/IF/IAY/3375973),Construction of PMAY-G House for Individuals -PMAY-G  REG. NO. WB3289974 ,20/10/2020 ,17190 ,0 ,17385 ,0 ,15/01/2020,17385,0,0,0,0  ,17385,
(3201009002/IF/IAY/3375971),Construction of PMAY-G House for Individuals -PMAY-G  REG. NO. WB3124954 ,20/10/2020 ,17190 ,0 ,17385 ,0 ,15/01/2020,17385,0,0,0,0  ,17385,
(3201009002/IF/IAY/1623257),Construction of IAY House -IAY REG. NO. WB2281601 ,02/07/2018 ,16200 ,0 ,16020 ,0 ,07/08/2017,16020,0,0,0,0  ,16020,
(3201009002/IF/IAY/3375970),Construction of PMAY-G House for Individuals -PMAY-G  REG. NO. WB3065493 ,20/10/2020 ,17190 ,0 ,17385 ,0 ,15/01/2020,17385,0,0,0,0  ,17385,
(3201009002/IF/IAY/3375980),Construction of PMAY-G House for Individuals -PMAY-G  REG. NO. WB4685061 ,30/10/2020 ,17190 ,0 ,17385 ,0 ,15/01/2020,17385,0,0,0,0  ,17385,
(3201009002/IF/IAY/3375960),Construction of PMAY-G House for Individuals -PMAY-G  REG. NO. WB3037852 ,20/10/2020 ,17190 ,0 ,17385 ,0 ,15/01/2020,17385,0,0,0,0  ,17385,
(3201009002/IF/IAY/3375963),Construction of PMAY-G House for Individuals -PMAY-G  REG. NO. WB2282057 ,20/10/2020 ,17190 ,0 ,17385 ,0 ,15/01/2020,17385,0,0,0,0  ,17385,
(3201009002/IF/IAY/1617703),Construction of IAY House -IAY REG. NO. WB1745964 ,02/07/2018 ,16200 ,0 ,16020 ,0 ,13/08/2017,16020,0,0,0,0  ,16020,
(3201009002/IF/IAY/3375946),Construction of PMAY-G House for Individuals -PMAY-G  REG. NO. WB2652160 ,20/10/2020 ,17190 ,0 ,17385 ,0 ,15/01/2020,17385,0,0,0,0  ,17385,
(3201009002/IF/IAY/3375958),Construction of PMAY-G House for Individuals -PMAY-G  REG. NO. WB2988451 ,20/10/2020 ,17190 ,0 ,17385 ,0 ,15/01/2020,17385,0,0,0,0  ,17385,
(3201009002/IF/IAY/2134535),Construction of PMAY-G House for Individuals -PMAY-G  REG. NO. WB2746922 ,22/01/2019 ,17190 ,0 ,17190 ,0 ,12/02/2018,17190,0,0,0,0  ,17190,
(3201009002/IF/IAY/3375934),Construction of PMAY-G House for Individuals -PMAY-G  REG. NO. WB3059843 ,20/10/2020 ,17190 ,0 ,17385 ,0 ,15/01/2020,17385,0,0,0,0  ,17385,
(3201009002/IF/IAY/3375938),Construction of PMAY-G House for Individuals -PMAY-G  REG. NO. WB2998647 ,20/10/2020 ,17190 ,0 ,17385 ,0 ,15/01/2020,17385,0,0,0,0  ,17385,
(3201009002/IF/IAY/3375933),Construction of PMAY-G House for Individuals -PMAY-G  REG. NO. WB2275962 ,20/10/2020 ,17190 ,0 ,17385 ,0 ,15/01/2020,17385,0,0,0,0  ,17385,
(3201009002/IF/IAY/3375932),Construction of PMAY-G House for Individuals -PMAY-G  REG. NO. WB5132572 ,20/10/2020 ,17190 ,0 ,17385 ,0 ,24/02/2020,17385,0,0,0,0  ,17385,
(3201009002/IF/IAY/3375953),Construction of PMAY-G House for Individuals -PMAY-G  REG. NO. WB3983196 ,20/10/2020 ,17190 ,0 ,17385 ,0 ,24/02/2020,17385,0,0,0,0  ,17385,
(3201009002/IF/IAY/3723025),Construction of PMAY-G House for Individuals -PMAY-G  REG. NO. WB3318665 ,20/11/2020 ,18360 ,0 ,15961 ,0 ,24/02/2020,15961,0,0,0,0  ,15961,
(3201009002/IF/IAY/3375943),Construction of PMAY-G House for Individuals -PMAY-G  REG. NO. WB3311099 ,17/09/2021 ,19170 ,0 ,17580 ,0 ,15/01/2020,17580,0,0,0,0  ,17580,
(3201009002/IF/IAY/3244463),Construction of PMAY-G House for Individuals -PMAY-G  REG. NO. WB2172602 ,17/09/2021 ,19170 ,0 ,17190 ,0 ,28/11/2019,17190,0,0,0,0  ,17190,
(3201009002/IF/IAY/3244469),Construction of PMAY-G House for Individuals -PMAY-G  REG. NO. WB2122449 ,17/09/2021 ,19170 ,0 ,17190 ,0 ,28/11/2019,17190,0,0,0,0  ,17190,
(3201009002/IF/IAY/3244458),Construction of PMAY-G House for Individuals -PMAY-G  REG. NO. WB3857550 ,17/09/2021 ,19170 ,0 ,17190 ,0 ,28/11/2019,17190,0,0,0,0  ,17190,
(3201009002/IF/IAY/3244443),Construction of PMAY-G House for Individuals -PMAY-G  REG. NO. WB2143037 ,17/09/2021 ,18360 ,0 ,17190 ,0 ,28/11/2019,17190,0,0,0,0  ,17190,
(3201009002/IF/IAY/3244440),Construction of PMAY-G House for Individuals -PMAY-G  REG. NO. WB2886490 ,17/09/2021 ,18360 ,0 ,17190 ,0 ,28/11/2019,17190,0,0,0,0  ,17190,
(3201009002/IF/IAY/3244474),Construction of PMAY-G House for Individuals -PMAY-G  REG. NO. WB3281729 ,17/09/2021 ,19170 ,0 ,16808 ,0 ,26/11/2019,16808,0,0,0,0  ,16808,
(3201009002/IF/IAY/3244430),Construction of PMAY-G House for Individuals -PMAY-G  REG. NO. WB1640316 ,17/09/2021 ,18360 ,0 ,17190 ,0 ,26/11/2019,17190,0,0,0,0  ,17190,
(3201009002/IF/IAY/3244425),Construction of PMAY-G House for Individuals -PMAY-G  REG. NO. WB1969410 ,17/09/2021 ,18360 ,0 ,17190 ,0 ,28/11/2019,17190,0,0,0,0  ,17190,
(3201009002/IF/IAY/4116452),Construction of PMAY-G House for Individuals -PMAY-G  REG. NO. WB2193268 ,15/09/2021 ,19170 ,0 ,18822 ,0 ,24/06/2020,18822,0,0,0,0  ,18822,
(3201009002/IF/IAY/3244423),Construction of PMAY-G House for Individuals -PMAY-G  REG. NO. WB3124982 ,17/09/2021 ,18360 ,0 ,17190 ,0 ,28/11/2019,17190,0,0,0,0  ,17190,
(3201009002/IF/IAY/3244459),Construction of PMAY-G House for Individuals -PMAY-G  REG. NO. WB3293564 ,17/09/2021 ,19170 ,0 ,17190 ,0 ,26/11/2019,17190,0,0,0,0  ,17190,
(3201009002/IF/IAY/3244418),Construction of PMAY-G House for Individuals -PMAY-G  REG. NO. WB2122330 ,17/09/2021 ,18360 ,0 ,17190 ,0 ,28/11/2019,17190,0,0,0,0  ,17190,
(3201009002/IF/IAY/4116518),Construction of PMAY-G House for Individuals -PMAY-G  REG. NO. WB1937949 ,15/09/2021 ,19170 ,0 ,18822 ,0 ,24/06/2020,18822,0,0,0,0  ,18822,
(3201009002/IF/IAY/3244398),Construction of PMAY-G House for Individuals -PMAY-G  REG. NO. WB1942382 ,17/09/2021 ,18360 ,0 ,17190 ,0 ,26/11/2019,17190,0,0,0,0  ,17190,
(3201009002/IF/IAY/3244364),Construction of PMAY-G House for Individuals -PMAY-G  REG. NO. WB4896806 ,17/09/2021 ,18360 ,0 ,17190 ,0 ,28/11/2019,17190,0,0,0,0  ,17190,
(3201009002/IF/IAY/3244344),Construction of PMAY-G House for Individuals -PMAY-G  REG. NO. WB4033464 ,19/09/2021 ,18360 ,0 ,16999 ,0 ,26/11/2019,16999,0,0,0,0  ,16999,
(3201009002/IF/IAY/3244367),Construction of PMAY-G House for Individuals -PMAY-G  REG. NO. WB2591942 ,17/09/2021 ,18360 ,0 ,17190 ,0 ,28/11/2019,17190,0,0,0,0  ,17190,
(3201009002/IF/IAY/3244334),Construction of PMAY-G House for Individuals -PMAY-G  REG. NO. WB1944644 ,17/09/2021 ,18360 ,0 ,17190 ,0 ,26/11/2019,17190,0,0,0,0  ,17190,
(3201009002/IF/IAY/3244328),Construction of PMAY-G House for Individuals -PMAY-G  REG. NO. WB1602944 ,17/09/2021 ,18360 ,0 ,17190 ,0 ,26/11/2019,17190,0,0,0,0  ,17190,
(3201009002/IF/IAY/3244331),Construction of PMAY-G House for Individuals -PMAY-G  REG. NO. WB1645801 ,17/09/2021 ,18360 ,0 ,17190 ,0 ,26/11/2019,17190,0,0,0,0  ,17190,
(3201009002/IF/IAY/3244376),Construction of PMAY-G House for Individuals -PMAY-G  REG. NO. WB3321094 ,17/09/2021 ,18360 ,0 ,17190 ,0 ,28/11/2019,17190,0,0,0,0  ,17190,
(3201009002/IF/IAY/3244320),Construction of PMAY-G House for Individuals -PMAY-G  REG. NO. WB2153736 ,17/09/2021 ,18360 ,0 ,17190 ,0 ,28/11/2019,17190,0,0,0,0  ,17190,
(3201009002/IF/IAY/3375937),Construction of PMAY-G House for Individuals -PMAY-G  REG. NO. WB4803849 ,20/10/2020 ,17190 ,0 ,17385 ,0 ,15/01/2020,17385,0,0,0,0  ,17385,
(3201009002/IF/IAY/3244295),Construction of PMAY-G House for Individuals -PMAY-G  REG. NO. WB3491240 ,17/09/2021 ,18360 ,0 ,17190 ,0 ,28/11/2019,17190,0,0,0,0  ,17190,
(3201009002/IF/IAY/3244396),Construction of PMAY-G House for Individuals -PMAY-G  REG. NO. WB2188626 ,17/09/2021 ,18360 ,0 ,16426 ,0 ,28/11/2019,16426,0,0,0,0  ,16426,
(3201009002/IF/IAY/1614556),Construction of IAY House -IAY REG. NO. WB1431616 ,02/07/2018 ,16200 ,0 ,16020 ,0 ,13/08/2017,16020,0,0,0,0  ,16020,
(3201009002/IF/IAY/3244305),Construction of PMAY-G House for Individuals -PMAY-G  REG. NO. WB1999870 ,17/09/2021 ,18360 ,0 ,17190 ,0 ,28/11/2019,17190,0,0,0,0  ,17190,
(3201009002/IF/IAY/1613866),Construction of IAY House -IAY REG. NO. WB1359241 ,02/07/2018 ,16200 ,0 ,16020 ,0 ,13/08/2017,16020,0,0,0,0  ,16020,
(3201009002/IF/IAY/1594386),Construction of IAY House -IAY REG. NO. WB2666378 ,02/07/2018 ,16200 ,0 ,16200 ,0 ,13/08/2017,16200,0,0,0,0  ,16200,
(3201009002/IF/IAY/1614904),Construction of IAY House -IAY REG. NO. WB1468943 ,02/07/2018 ,16200 ,0 ,16020 ,0 ,13/08/2017,16020,0,0,0,0  ,16020,
(3201009002/IF/IAY/3244286),Construction of PMAY-G House for Individuals -PMAY-G  REG. NO. WB4969859 ,17/09/2021 ,18360 ,0 ,17190 ,0 ,28/11/2019,17190,0,0,0,0  ,17190,
(3201009002/IF/IAY/3375962),Construction of PMAY-G House for Individuals -PMAY-G  REG. NO. WB4550897 ,20/10/2020 ,17190 ,0 ,17385 ,0 ,15/01/2020,17385,0,0,0,0  ,17385,
(3201009002/IF/IAY/1590496),Construction of IAY House -IAY REG. NO. WB2340052 ,02/07/2018 ,16200 ,0 ,16020 ,0 ,13/08/2017,16020,0,0,0,0  ,16020,
(3201009002/IF/IAY/1614511),Construction of IAY House -IAY REG. NO. WB1427168 ,02/07/2018 ,16200 ,0 ,16020 ,0 ,13/08/2017,16020,0,0,0,0  ,16020,
(3201009002/IF/IAY/1575620),Construction of IAY House -IAY REG. NO. WB1463639 ,02/07/2018 ,16200 ,0 ,16020 ,0 ,13/08/2017,16020,0,0,0,0  ,16020,
(3201009002/IF/IAY/3244299),Construction of PMAY-G House for Individuals -PMAY-G  REG. NO. WB1592720 ,17/09/2021 ,18360 ,0 ,17190 ,0 ,26/11/2019,17190,0,0,0,0  ,17190,
(3201009002/IF/IAY/3244482),Construction of PMAY-G House for Individuals -PMAY-G  REG. NO. WB3234579 ,17/09/2021 ,19170 ,0 ,17190 ,0 ,28/11/2019,17190,0,0,0,0  ,17190,
(3201009002/IF/IAY/1583581),Construction of IAY House -IAY REG. NO. WB1468373 ,02/07/2018 ,16200 ,0 ,16200 ,0 ,13/08/2017,16200,0,0,0,0  ,16200,
(3201009002/IF/IAY/3244434),Construction of PMAY-G House for Individuals -PMAY-G  REG. NO. WB1640661 ,17/09/2021 ,18360 ,0 ,17190 ,0 ,26/11/2019,17190,0,0,0,0  ,17190,
(3201009002/IF/IAY/1515417),Construction of IAY House -IAY REG. NO. WB2288533 ,02/07/2018 ,16200 ,0 ,16020 ,0 ,07/08/2017,16020,0,0,0,0  ,16020,
(3201009002/IF/IAY/1552550),Construction of IAY House -IAY REG. NO. WB2310531 ,02/07/2018 ,16200 ,0 ,16020 ,0 ,13/08/2017,16020,0,0,0,0  ,16020,
(3201009002/IF/IAY/1553809),Construction of IAY House -IAY REG. NO. WB2555912 ,02/07/2018 ,16200 ,0 ,16020 ,0 ,25/08/2017,16020,0,0,0,0  ,16020,
(3201009002/IF/IAY/1499507),Construction of IAY House -IAY REG. NO. WB2317747 ,02/07/2018 ,16200 ,0 ,16020 ,0 ,13/08/2017,16020,0,0,0,0  ,16020,
(3201009002/IF/IAY/1499795),Construction of IAY House -IAY REG. NO. WB2341097 ,02/07/2018 ,16200 ,0 ,16020 ,0 ,13/08/2017,16020,0,0,0,0  ,16020,
(3201009002/IF/IAY/1589564),Construction of IAY House -IAY REG. NO. WB2281717 ,02/07/2018 ,16200 ,0 ,16020 ,0 ,13/08/2017,16020,0,0,0,0  ,16020,
(3201009002/IF/IAY/1473380),Construction of IAY House -IAY REG. NO. WB2341355 ,02/07/2018 ,16200 ,0 ,16020 ,0 ,13/08/2017,16020,0,0,0,0  ,16020,
(3201009002/IF/IAY/1499041),Construction of IAY House -IAY REG. NO. WB2279200 ,02/07/2018 ,16200 ,0 ,16020 ,0 ,13/08/2017,16020,0,0,0,0  ,16020,
(3201009002/IF/IAY/1473293),Construction of IAY House -IAY REG. NO. WB2339164 ,02/07/2018 ,16200 ,0 ,16020 ,0 ,13/08/2017,16020,0,0,0,0  ,16020,
(3201009002/IF/IAY/1499454),Construction of IAY House -IAY REG. NO. WB2313898 ,02/07/2018 ,16200 ,0 ,15120 ,0 ,13/08/2017,15120,0,0,0,0  ,15120,
(3201009002/IF/IAY/3375930),Construction of PMAY-G House for Individuals -PMAY-G  REG. NO. WB3172669 ,20/10/2020 ,17190 ,0 ,17385 ,0 ,15/01/2020,17385,0,0,0,0  ,17385,
(3201009002/IF/IAY/1471408),Construction of IAY House -IAY REG. NO. WB2290154 ,02/07/2018 ,16200 ,0 ,16020 ,0 ,13/08/2017,16020,0,0,0,0  ,16020,
(3201009002/IF/IAY/1590656),Construction of IAY House -IAY REG. NO. WB2349711 ,02/07/2018 ,16200 ,0 ,16020 ,0 ,13/08/2017,16020,0,0,0,0  ,16020,
(3201009002/IF/IAY/3375920),Construction of PMAY-G House for Individuals -PMAY-G  REG. NO. WB2652057 ,20/10/2020 ,17190 ,0 ,17385 ,0 ,15/01/2020,17385,0,0,0,0  ,17385,
(3201009002/IF/IAY/3375927),Construction of PMAY-G House for Individuals -PMAY-G  REG. NO. WB1473088 ,20/10/2020 ,17190 ,0 ,17385 ,0 ,03/03/2020,17385,0,0,0,0  ,17385,
(3201009002/IF/IAY/3244494),Construction of PMAY-G House for Individuals -PMAY-G  REG. NO. WB1546116 ,09/07/2020 ,18360 ,0 ,17190 ,0 ,26/11/2019,17190,0,0,0,0  ,17190,
(3201009002/IF/IAY/3375924),Construction of PMAY-G House for Individuals -PMAY-G  REG. NO. WB2282218 ,20/10/2020 ,17190 ,0 ,17385 ,0 ,15/01/2020,17385,0,0,0,0  ,17385,
(3201009002/IF/IAY/1515335),Construction of IAY House -IAY REG. NO. WB2277705 ,02/07/2018 ,16200 ,0 ,16020 ,0 ,07/08/2017,16020,0,0,0,0  ,16020,
(3201009002/IF/IAY/3244477),Construction of PMAY-G House for Individuals -PMAY-G  REG. NO. WB5176260 ,02/07/2020 ,18360 ,0 ,17190 ,0 ,26/11/2019,17190,0,0,0,0  ,17190,
(3201009002/IF/IAY/3244417),Construction of PMAY-G House for Individuals -PMAY-G  REG. NO. WB1640416 ,29/10/2020 ,18360 ,0 ,17190 ,0 ,26/11/2019,17190,0,0,0,0  ,17190,
(3201009002/IF/IAY/3244427),Construction of PMAY-G House for Individuals -PMAY-G  REG. NO. WB2225426 ,09/07/2020 ,18360 ,0 ,17190 ,0 ,28/11/2019,17190,0,0,0,0  ,17190,
(3201009002/IF/IAY/3244414),Construction of PMAY-G House for Individuals -PMAY-G  REG. NO. WB1586959 ,02/07/2020 ,18360 ,0 ,17190 ,0 ,26/11/2019,17190,0,0,0,0  ,17190,
(3201009002/IF/IAY/3244449),Construction of PMAY-G House for Individuals -PMAY-G  REG. NO. WB1944046 ,09/07/2020 ,18360 ,0 ,17190 ,0 ,26/11/2019,17190,0,0,0,0  ,17190,
(3201009002/IF/IAY/3375918),Construction of PMAY-G House for Individuals -PMAY-G  REG. NO. WB4914981 ,20/10/2020 ,17190 ,0 ,17385 ,0 ,15/01/2020,17385,0,0,0,0  ,17385,
(3201009002/IF/IAY/1499628),Construction of IAY House -IAY REG. NO. WB2327374 ,02/07/2018 ,16200 ,0 ,14220 ,0 ,13/08/2017,14220,0,0,0,0  ,14220,
(3201009002/IF/IAY/3244335),Construction of PMAY-G House for Individuals -PMAY-G  REG. NO. WB3943439 ,02/07/2020 ,18360 ,0 ,17190 ,0 ,26/11/2019,17190,0,0,0,0  ,17190,
(3201009002/IF/IAY/3244345),Construction of PMAY-G House for Individuals -PMAY-G  REG. NO. WB2194505 ,02/07/2020 ,18360 ,0 ,17190 ,0 ,28/11/2019,17190,0,0,0,0  ,17190,
(3201009002/IF/IAY/1590357),Construction of IAY House -IAY REG. NO. WB2331817 ,02/07/2018 ,16200 ,0 ,16020 ,0 ,13/08/2017,16020,0,0,0,0  ,16020,
(3201009002/IF/IAY/3244290),Construction of PMAY-G House for Individuals -PMAY-G  REG. NO. WB2278051 ,09/07/2020 ,18360 ,0 ,17190 ,0 ,26/11/2019,17190,0,0,0,0  ,17190,
(3201009002/IF/IAY/3244277),Construction of PMAY-G House for Individuals -PMAY-G  REG. NO. WB1634157 ,02/07/2020 ,18360 ,0 ,17190 ,0 ,26/11/2019,17190,0,0,0,0  ,17190,
(3201009002/IF/IAY/3244381),Construction of PMAY-G House for Individuals -PMAY-G  REG. NO. WB1962482 ,02/07/2020 ,18360 ,0 ,17190 ,0 ,28/11/2019,17190,0,0,0,0  ,17190,
(3201009002/IF/IAY/3244266),Construction of PMAY-G House for Individuals -PMAY-G  REG. NO. WB2886926 ,09/07/2020 ,18360 ,0 ,17190 ,0 ,28/11/2019,17190,0,0,0,0  ,17190,
(3201009002/IF/IAY/3244274),Construction of PMAY-G House for Individuals -PMAY-G  REG. NO. WB1921989 ,17/09/2021 ,18360 ,0 ,17190 ,0 ,26/11/2019,17190,0,0,0,0  ,17190,
(3201009002/IF/IAY/3244278),Construction of PMAY-G House for Individuals -PMAY-G  REG. NO. WB1620199 ,17/09/2021 ,18360 ,0 ,17190 ,0 ,26/11/2019,17190,0,0,0,0  ,17190,
(3201009002/IF/IAY/1473719),Construction of IAY House -IAY REG. NO. WB2350612 ,02/07/2018 ,16200 ,0 ,16200 ,0 ,13/08/2017,16200,0,0,0,0  ,16200,
(3201009002/IF/IAY/3244261),Construction of PMAY-G House for Individuals -PMAY-G  REG. NO. WB1528933 ,17/09/2021 ,18360 ,0 ,17190 ,0 ,26/11/2019,17190,0,0,0,0  ,17190,
(3201009002/IF/IAY/3244247),Construction of PMAY-G House for Individuals -PMAY-G  REG. NO. WB3048605 ,17/09/2021 ,18360 ,0 ,15089 ,0 ,26/11/2019,15089,0,0,0,0  ,15089,
(3201009002/IF/IAY/1472527),Construction of IAY House -IAY REG. NO. WB2320089 ,02/07/2018 ,16200 ,0 ,16020 ,0 ,13/08/2017,16020,0,0,0,0  ,16020,
(3201009002/IF/IAY/3244242),Construction of PMAY-G House for Individuals -PMAY-G  REG. NO. WB4907980 ,19/09/2021 ,18360 ,0 ,17190 ,0 ,26/11/2019,17190,0,0,0,0  ,17190,
(3201009002/IF/IAY/3244279),Construction of PMAY-G House for Individuals -PMAY-G  REG. NO. WB2201028 ,02/07/2020 ,18360 ,0 ,17190 ,0 ,28/11/2019,17190,0,0,0,0  ,17190,
(3201009002/IF/IAY/3244282),Construction of PMAY-G House for Individuals -PMAY-G  REG. NO. WB4712004 ,17/09/2021 ,18360 ,0 ,17190 ,0 ,28/11/2019,17190,0,0,0,0  ,17190,
(3201009002/IF/IAY/3244273),Construction of PMAY-G House for Individuals -PMAY-G  REG. NO. WB3972554 ,02/07/2020 ,18360 ,0 ,17190 ,0 ,26/11/2019,17190,0,0,0,0  ,17190,
(3201009002/IF/IAY/3244206),Construction of PMAY-G House for Individuals -PMAY-G  REG. NO. WB1628465 ,17/09/2021 ,18360 ,0 ,17190 ,0 ,26/11/2019,17190,0,0,0,0  ,17190,
(3201009002/IF/IAY/3244212),Construction of PMAY-G House for Individuals -PMAY-G  REG. NO. WB2113224 ,19/09/2021 ,18360 ,0 ,17190 ,0 ,28/11/2019,17190,0,0,0,0  ,17190,
(3201009002/IF/IAY/3244208),Construction of PMAY-G House for Individuals -PMAY-G  REG. NO. WB4921204 ,19/09/2021 ,17190 ,0 ,17190 ,0 ,26/11/2019,17190,0,0,0,0  ,17190,
(3201009002/IF/IAY/3244217),Construction of PMAY-G House for Individuals -PMAY-G  REG. NO. WB2091606 ,19/09/2021 ,18360 ,0 ,17190 ,0 ,28/11/2019,17190,0,0,0,0  ,17190,
(3201009002/IF/IAY/3244147),Construction of PMAY-G House for Individuals -PMAY-G  REG. NO. WB4692924 ,17/09/2021 ,18360 ,0 ,17190 ,0 ,26/11/2019,17190,0,0,0,0  ,17190,
(3201009002/IF/IAY/3244243),Construction of PMAY-G House for Individuals -PMAY-G  REG. NO. WB1576794 ,17/09/2021 ,18360 ,0 ,17190 ,0 ,26/11/2019,17190,0,0,0,0  ,17190,
(3201009002/IF/IAY/3244136),Construction of PMAY-G House for Individuals -PMAY-G  REG. NO. WB1952838 ,17/09/2021 ,18360 ,0 ,17190 ,0 ,28/11/2019,17190,0,0,0,0  ,17190,
(3201009002/IF/IAY/3244141),Construction of PMAY-G House for Individuals -PMAY-G  REG. NO. WB1528345 ,17/09/2021 ,18360 ,0 ,17190 ,0 ,26/11/2019,17190,0,0,0,0  ,17190,
(3201009002/IF/IAY/3244267),Construction of PMAY-G House for Individuals -PMAY-G  REG. NO. WB1620209 ,17/09/2021 ,18360 ,0 ,17190 ,0 ,26/11/2019,17190,0,0,0,0  ,17190,
(3201009002/IF/IAY/1470365),Construction of IAY House -IAY REG. NO. WB2262160 ,02/07/2018 ,16200 ,0 ,16020 ,0 ,13/08/2017,16020,0,0,0,0  ,16020,
(3201009002/IF/IAY/3244129),Construction of PMAY-G House for Individuals -PMAY-G  REG. NO. WB2200605 ,17/09/2021 ,18360 ,0 ,17190 ,0 ,28/11/2019,17190,0,0,0,0  ,17190,
(3201009002/IF/IAY/3244127),Construction of PMAY-G House for Individuals -PMAY-G  REG. NO. WB3396074 ,17/09/2021 ,18360 ,0 ,17190 ,0 ,28/11/2019,17190,0,0,0,0  ,17190,
(3201009002/IF/IAY/1435573),Construction of IAY House -IAY REG. NO. WB2081323 ,02/07/2018 ,16200 ,0 ,16020 ,0 ,13/08/2017,16020,0,0,0,0  ,16020,
(3201009002/IF/IAY/3244154),Construction of PMAY-G House for Individuals -PMAY-G  REG. NO. WB4950847 ,17/09/2021 ,18360 ,0 ,17190 ,0 ,26/11/2019,17190,0,0,0,0  ,17190,
(3201009002/IF/IAY/1435746),Construction of IAY House -IAY REG. NO. WB2091128 ,02/07/2018 ,16200 ,0 ,16020 ,0 ,13/08/2017,16020,0,0,0,0  ,16020,
(3201009002/IF/IAY/1469435),Construction of IAY House -IAY REG. NO. WB2239211 ,02/07/2018 ,16200 ,0 ,15120 ,0 ,13/08/2017,15120,0,0,0,0  ,15120,
(3201009002/IF/IAY/1426058),Construction of IAY House -IAY REG. NO. WB1468215 ,02/07/2018 ,16200 ,0 ,16020 ,0 ,13/08/2017,16020,0,0,0,0  ,16020,
(3201009002/IF/IAY/1426059),Construction of IAY House -IAY REG. NO. WB1468243 ,02/07/2018 ,16200 ,0 ,16020 ,0 ,13/08/2017,16020,0,0,0,0  ,16020,
(3201009002/IF/IAY/1425949),Construction of IAY House -IAY REG. NO. WB1359205 ,02/07/2018 ,16200 ,0 ,16020 ,0 ,13/08/2017,16020,0,0,0,0  ,16020,
(3201009002/IF/IAY/1429108),Construction of IAY House -IAY REG. NO. WB1246664 ,02/07/2018 ,16200 ,0 ,16020 ,0 ,13/08/2017,16020,0,0,0,0  ,16020,
(3201009002/IF/IAY/1470025),Construction of IAY House -IAY REG. NO. WB2253516 ,02/07/2018 ,16200 ,0 ,16020 ,0 ,13/08/2017,16020,0,0,0,0  ,16020,
(3201009002/IF/IAY/1422464),Construction of IAY House -IAY REG. NO. WB1444086 ,02/07/2018 ,16200 ,0 ,16020 ,0 ,13/08/2017,16020,0,0,0,0  ,16020,
(3201009002/IF/IAY/1422993),Construction of IAY House -IAY REG. NO. WB1464036 ,02/07/2018 ,16200 ,0 ,16020 ,0 ,13/08/2017,16020,0,0,0,0  ,16020,
(3201009002/IF/IAY/1422242),Construction of IAY House -IAY REG. NO. WB1426636 ,02/07/2018 ,16200 ,0 ,16200 ,0 ,13/08/2017,16200,0,0,0,0  ,16200,
(3201009002/IF/IAY/1422229),Construction of IAY House -IAY REG. NO. WB1425383 ,02/07/2018 ,16200 ,0 ,16020 ,0 ,13/08/2017,16020,0,0,0,0  ,16020,
(3201009002/IF/IAY/1422227),Construction of IAY House -IAY REG. NO. WB1425277 ,02/07/2018 ,16200 ,0 ,16200 ,0 ,13/08/2017,16200,0,0,0,0  ,16200,
(3201009002/IF/IAY/1422199),Construction of IAY House -IAY REG. NO. WB1423741 ,02/07/2018 ,16200 ,0 ,16020 ,0 ,13/08/2017,16020,0,0,0,0  ,16020,
(3201009002/IF/IAY/1421941),Construction of IAY House -IAY REG. NO. WB1410413 ,02/07/2018 ,16200 ,0 ,16020 ,0 ,13/08/2017,16020,0,0,0,0  ,16020,
(3201009002/IF/IAY/1422245),Construction of IAY House -IAY REG. NO. WB1426877 ,02/07/2018 ,16200 ,0 ,16020 ,0 ,13/08/2017,16020,0,0,0,0  ,16020,
(3201009002/IF/IAY/1429278),Construction of IAY House -IAY REG. NO. WB1464018 ,02/07/2018 ,16200 ,0 ,16200 ,0 ,13/08/2017,16200,0,0,0,0  ,16200,
(3201009002/IF/IAY/3244246),Construction of PMAY-G House for Individuals -PMAY-G  REG. NO. WB2175621 ,09/07/2020 ,18360 ,0 ,17190 ,0 ,28/11/2019,17190,0,0,0,0  ,17190,
(3201009002/IF/IAY/3244232),Construction of PMAY-G House for Individuals -PMAY-G  REG. NO. WB4934227 ,09/07/2020 ,18360 ,0 ,17190 ,0 ,26/11/2019,17190,0,0,0,0  ,17190,
(3201009002/IF/IAY/1421853),Construction of IAY House -IAY REG. NO. WB1403809 ,02/07/2018 ,16200 ,0 ,16020 ,0 ,13/08/2017,16020,0,0,0,0  ,16020,
(3201009002/IF/IAY/1421815),Construction of IAY House -IAY REG. NO. WB1402537 ,02/07/2018 ,16200 ,0 ,16020 ,0 ,13/08/2017,16020,0,0,0,0  ,16020,
(3201009002/IF/IAY/3244237),Construction of PMAY-G House for Individuals -PMAY-G  REG. NO. WB2694243 ,02/07/2020 ,18360 ,0 ,17190 ,0 ,06/12/2019,17190,0,0,0,0  ,17190,
(3201009002/IF/IAY/3244135),Construction of PMAY-G House for Individuals -PMAY-G  REG. NO. WB2193176 ,15/07/2020 ,18360 ,0 ,17190 ,0 ,06/12/2019,17190,0,0,0,0  ,17190,
(3201009002/IF/IAY/3244104),Construction of PMAY-G House for Individuals -PMAY-G  REG. NO. WB1601046 ,02/07/2020 ,18360 ,0 ,17190 ,0 ,26/11/2019,17190,0,0,0,0  ,17190,
(3201009002/IF/IAY/3244131),Construction of PMAY-G House for Individuals -PMAY-G  REG. NO. WB2196362 ,09/07/2020 ,18360 ,0 ,17190 ,0 ,28/11/2019,17190,0,0,0,0  ,17190,
(3201009002/IF/IAY/3244164),Construction of PMAY-G House for Individuals -PMAY-G  REG. NO. WB1593563 ,09/07/2020 ,18360 ,0 ,17190 ,0 ,26/11/2019,17190,0,0,0,0  ,17190,
(3201009002/IF/IAY/3244073),Construction of PMAY-G House for Individuals -PMAY-G  REG. NO. WB1601111 ,02/07/2020 ,18360 ,0 ,17190 ,0 ,26/11/2019,17190,0,0,0,0  ,17190,
(3201009002/IF/IAY/3244153),Construction of PMAY-G House for Individuals -PMAY-G  REG. NO. WB1640335 ,17/09/2021 ,18360 ,0 ,17190 ,0 ,26/11/2019,17190,0,0,0,0  ,17190,
(3201009002/IF/IAY/1423049),Construction of IAY House -IAY REG. NO. WB1468430 ,02/07/2018 ,16200 ,0 ,16200 ,0 ,13/08/2017,16200,0,0,0,0  ,16200,
(3201009002/IF/IAY/3243991),Construction of PMAY-G House for Individuals -PMAY-G  REG. NO. WB3039198 ,09/07/2020 ,18360 ,0 ,17190 ,0 ,28/11/2019,17190,0,0,0,0  ,17190,
(3201009002/IF/IAY/3244051),Construction of PMAY-G House for Individuals -PMAY-G  REG. NO. WB2640638 ,02/07/2020 ,18360 ,0 ,17190 ,0 ,06/12/2019,17190,0,0,0,0  ,17190,
(3201009002/RC/320201060593588),Construction of CC road from Bhaluka Hatpara to Vidyasagar Child Academy at Bhaluka Hatpara. ,04/04/2022 ,13726.04 ,188487.63 ,12223 ,0 ,22/12/2020,12223,0,0,0,0  ,12223,
(3201009002/RC/320201060584944),Construction of CC road from the Babu Sam to Sanjay Santra at Bhaluka Sijaipur ,04/04/2022 ,16793.96 ,254849.1 ,15124 ,0 ,15/10/2020,15124,0,0,0,0  ,15124,
(3201009002/RC/320201060584942),Construction of CC road from the Piratala Pucca Rusta to H/O Babu Sam at Bhaluka Sijaipur ,04/04/2022 ,16793.69 ,254844.82 ,15132 ,0 ,15/10/2020,15132,0,0,0,0  ,15132,
(3201009002/IF/IAY/3244354),Construction of PMAY-G House for Individuals -PMAY-G  REG. NO. WB1927511 ,02/07/2020 ,18360 ,0 ,17190 ,0 ,26/11/2019,17190,0,0,0,0  ,17190,
(3201009002/RC/320201060578453),Construction of jhama bats from H/O-Purna Sarkar to H/O-Humayan Sekh at Anandabas. ,04/04/2022 ,46216.54 ,281463.88 ,40029 ,0 ,07/01/2021,40029,0,0,0,0  ,40029,
(3201009002/IF/IAY/4637335),Construction of PMAY-G House for Individuals -PMAY-G  REG. NO. WB1451235 ,15/07/2022 ,20070 ,0 ,19620 ,0 ,04/01/2021,19620,0,0,0,0  ,19620,
(3201009002/IF/IAY/3244182),Construction of PMAY-G House for Individuals -PMAY-G  REG. NO. WB3056732 ,17/09/2021 ,18360 ,0 ,17190 ,0 ,26/11/2019,17190,0,0,0,0  ,17190,
(3201009002/IF/IAY/4637105),Construction of PMAY-G House for Individuals -PMAY-G  REG. NO. WB4745761 ,15/07/2022 ,20070 ,0 ,19620 ,0 ,03/01/2021,19620,0,0,0,0  ,19620,
(3201009002/RC/320201060578483),Construction of CC road from H/O-Sharkat Sk to H/O-Liyakat Sekh at Bhaluka. ,04/04/2022 ,15854.78 ,205857.74 ,12852 ,0 ,16/10/2020,12852,0,0,0,0  ,12852,
(3201009002/IF/IAY/3243959),Construction of PMAY-G House for Individuals -PMAY-G  REG. NO. WB1586136 ,02/07/2020 ,18360 ,0 ,17190 ,0 ,26/11/2019,17190,0,0,0,0  ,17190,
(3201009002/IF/IAY/4637101),Construction of PMAY-G House for Individuals -PMAY-G  REG. NO. WB4112015 ,15/07/2022 ,20070 ,0 ,19407 ,0 ,03/01/2021,19407,0,0,0,0  ,19407,
(3201009002/IF/IAY/3244119),Construction of PMAY-G House for Individuals -PMAY-G  REG. NO. WB1578640 ,02/07/2020 ,18360 ,0 ,17190 ,0 ,26/11/2019,17190,0,0,0,0  ,17190,
(3201009002/IF/IAY/3244065),Construction of PMAY-G House for Individuals -PMAY-G  REG. NO. WB1662072 ,09/07/2020 ,18360 ,0 ,17190 ,0 ,26/11/2019,17190,0,0,0,0  ,17190,
(3201009002/IF/IAY/3244126),Construction of PMAY-G House for Individuals -PMAY-G  REG. NO. WB4905688 ,17/09/2021 ,18360 ,0 ,17190 ,0 ,26/11/2019,17190,0,0,0,0  ,17190,
(3201009002/IF/IAY/3244098),Construction of PMAY-G House for Individuals -PMAY-G  REG. NO. WB1621324 ,02/07/2020 ,18360 ,0 ,17190 ,0 ,26/11/2019,17190,0,0,0,0  ,17190,
(3201009002/IF/IAY/3244115),Construction of PMAY-G House for Individuals -PMAY-G  REG. NO. WB1969265 ,17/09/2021 ,17190 ,0 ,17190 ,0 ,28/11/2019,17190,0,0,0,0  ,17190,
(3201009002/IF/IAY/4637098),Construction of PMAY-G House for Individuals -PMAY-G  REG. NO. WB3797826 ,15/07/2022 ,20070 ,0 ,19407 ,0 ,03/01/2021,19407,0,0,0,0  ,19407,
(3201009002/IF/IAY/4637104),Construction of PMAY-G House for Individuals -PMAY-G  REG. NO. WB4744818 ,15/07/2022 ,20070 ,0 ,19407 ,0 ,03/01/2021,19407,0,0,0,0  ,19407,
(3201009002/IF/IAY/3244097),Construction of PMAY-G House for Individuals -PMAY-G  REG. NO. WB1604361 ,17/09/2021 ,18360 ,0 ,17190 ,0 ,26/11/2019,17190,0,0,0,0  ,17190,
(3201009002/IF/IAY/3244078),Construction of PMAY-G House for Individuals -PMAY-G  REG. NO. WB1624447 ,17/09/2021 ,18360 ,0 ,17190 ,0 ,26/11/2019,17190,0,0,0,0  ,17190,
(3201009002/IF/IAY/3244064),Construction of PMAY-G House for Individuals -PMAY-G  REG. NO. WB1620181 ,17/09/2021 ,18360 ,0 ,17190 ,0 ,26/11/2019,17190,0,0,0,0  ,17190,
(3201009002/IF/IAY/3244121),Construction of PMAY-G House for Individuals -PMAY-G  REG. NO. WB3038170 ,17/09/2021 ,18360 ,0 ,17190 ,0 ,28/11/2019,17190,0,0,0,0  ,17190,
(3201009002/IF/IAY/3244056),Construction of PMAY-G House for Individuals -PMAY-G  REG. NO. WB1882946 ,17/09/2021 ,18360 ,0 ,17190 ,0 ,28/11/2019,17190,0,0,0,0  ,17190,
(3201009002/IF/IAY/3244063),Construction of PMAY-G House for Individuals -PMAY-G  REG. NO. WB2286283 ,17/09/2021 ,18360 ,0 ,17190 ,0 ,26/11/2019,17190,0,0,0,0  ,17190,
(3201009002/IF/IAY/3244041),Construction of PMAY-G House for Individuals -PMAY-G  REG. NO. WB2282262 ,17/09/2021 ,18360 ,0 ,17190 ,0 ,26/11/2019,17190,0,0,0,0  ,17190,
(3201009002/IF/IAY/3244111),Construction of PMAY-G House for Individuals -PMAY-G  REG. NO. WB2196603 ,17/09/2021 ,18360 ,0 ,17190 ,0 ,28/11/2019,17190,0,0,0,0  ,17190,
(3201009002/IF/IAY/3244040),Construction of PMAY-G House for Individuals -PMAY-G  REG. NO. WB1933803 ,17/09/2021 ,18360 ,0 ,17190 ,0 ,26/11/2019,17190,0,0,0,0  ,17190,
(3201009002/IF/IAY/3244014),Construction of PMAY-G House for Individuals -PMAY-G  REG. NO. WB4998485 ,17/09/2021 ,18360 ,0 ,14898 ,0 ,26/11/2019,14898,0,0,0,0  ,14898,
(3201009002/IF/IAY/3244006),Construction of PMAY-G House for Individuals -PMAY-G  REG. NO. WB2616052 ,17/09/2021 ,18360 ,0 ,17190 ,0 ,06/12/2019,17190,0,0,0,0  ,17190,
(3201009002/IF/IAY/3244114),Construction of PMAY-G House for Individuals -PMAY-G  REG. NO. WB1632289 ,17/09/2021 ,18360 ,0 ,17190 ,0 ,26/11/2019,17190,0,0,0,0  ,17190,
(3201009002/IF/IAY/3243995),Construction of PMAY-G House for Individuals -PMAY-G  REG. NO. WB3172697 ,17/09/2021 ,18360 ,0 ,17190 ,0 ,26/11/2019,17190,0,0,0,0  ,17190,
(3201009002/IF/IAY/4637102),Construction of PMAY-G House for Individuals -PMAY-G  REG. NO. WB4601609 ,15/07/2022 ,20070 ,0 ,19620 ,0 ,03/01/2021,19620,0,0,0,0  ,19620,
(3201009002/IF/IAY/3243997),Construction of PMAY-G House for Individuals -PMAY-G  REG. NO. WB2173021 ,17/09/2021 ,18360 ,0 ,17190 ,0 ,28/11/2019,17190,0,0,0,0  ,17190,
(3201009002/IF/IAY/3244000),Construction of PMAY-G House for Individuals -PMAY-G  REG. NO. WB1582622 ,17/09/2021 ,18360 ,0 ,17190 ,0 ,26/11/2019,17190,0,0,0,0  ,17190,
(3201009002/IF/IAY/3243993),Construction of PMAY-G House for Individuals -PMAY-G  REG. NO. WB1587568 ,17/09/2021 ,18360 ,0 ,17190 ,0 ,26/11/2019,17190,0,0,0,0  ,17190,
(3201009002/IF/IAY/3243981),Construction of PMAY-G House for Individuals -PMAY-G  REG. NO. WB2208468 ,17/09/2021 ,18360 ,0 ,17190 ,0 ,28/11/2019,17190,0,0,0,0  ,17190,
(3201009002/IF/IAY/3243930),Construction of PMAY-G House for Individuals -PMAY-G  REG. NO. WB1645418 ,17/09/2021 ,18360 ,0 ,17190 ,0 ,26/11/2019,17190,0,0,0,0  ,17190,
(3201009002/IF/IAY/3243964),Construction of PMAY-G House for Individuals -PMAY-G  REG. NO. WB2223832 ,17/09/2021 ,18360 ,0 ,16999 ,0 ,28/11/2019,16999,0,0,0,0  ,16999,
(3201009002/IF/IAY/3243927),Construction of PMAY-G House for Individuals -PMAY-G  REG. NO. WB1633870 ,17/09/2021 ,18360 ,0 ,17190 ,0 ,26/11/2019,17190,0,0,0,0  ,17190,
(3201009002/IF/IAY/3243940),Construction of PMAY-G House for Individuals -PMAY-G  REG. NO. WB4829153 ,17/09/2021 ,18360 ,0 ,17190 ,0 ,26/11/2019,17190,0,0,0,0  ,17190,
(3201009002/IF/IAY/3243897),Construction of PMAY-G House for Individuals -PMAY-G  REG. NO. WB2170447 ,17/09/2021 ,18360 ,0 ,17190 ,0 ,28/11/2019,17190,0,0,0,0  ,17190,
(3201009002/IF/IAY/1421714),Construction of IAY House -IAY REG. NO. WB1396811 ,02/07/2018 ,16200 ,0 ,16020 ,0 ,13/08/2017,16020,0,0,0,0  ,16020,
(3201009002/IF/IAY/3244042),Construction of PMAY-G House for Individuals -PMAY-G  REG. NO. WB1591445 ,17/09/2021 ,18360 ,0 ,17190 ,0 ,26/11/2019,17190,0,0,0,0  ,17190,
(3201009002/IF/IAY/1421411),Construction of IAY House -IAY REG. NO. WB1374720 ,02/07/2018 ,16200 ,0 ,16020 ,0 ,13/08/2017,16020,0,0,0,0  ,16020,
(3201009002/IF/IAY/1421572),Construction of IAY House -IAY REG. NO. WB1385502 ,02/07/2018 ,16200 ,0 ,16020 ,0 ,13/08/2017,16020,0,0,0,0  ,16020,
(3201009002/IF/IAY/1421410),Construction of IAY House -IAY REG. NO. WB1374714 ,02/07/2018 ,16200 ,0 ,16020 ,0 ,13/08/2017,16020,0,0,0,0  ,16020,
(3201009002/IF/IAY/3243898),Construction of PMAY-G House for Individuals -PMAY-G  REG. NO. WB4815963 ,17/09/2021 ,18360 ,0 ,17190 ,0 ,26/11/2019,17190,0,0,0,0  ,17190,
(3201009002/IF/IAY/1420636),Construction of IAY House -IAY REG. NO. WB1279553 ,02/07/2018 ,16200 ,0 ,16020 ,0 ,13/08/2017,16020,0,0,0,0  ,16020,
(3201009002/IF/IAY/1421409),Construction of IAY House -IAY REG. NO. WB1374669 ,02/07/2018 ,16200 ,0 ,16200 ,0 ,13/08/2017,16200,0,0,0,0  ,16200,
(3201009002/IF/IAY/1371146),Construction of IAY House -IAY REG. NO. WB1233681 ,24/07/2018 ,16200 ,0 ,15840 ,0 ,17/02/2017,15840,0,0,0,0  ,15840,
(3201009002/IF/IAY/1348969),Construction of IAY House -IAY REG. NO. WB2254702 ,03/07/2018 ,16200 ,0 ,15840 ,0 ,29/03/2017,15840,0,0,0,0  ,15840,
(3201009002/IF/IAY/1419777),Construction of IAY House -IAY REG. NO. WB1164655 ,02/07/2018 ,16200 ,0 ,16200 ,0 ,13/08/2017,16200,0,0,0,0  ,16200,
(3201009002/IF/IAY/1345038),Construction of IAY House -IAY REG. NO. WB1372607 ,03/07/2018 ,16200 ,0 ,15840 ,0 ,29/03/2017,15840,0,0,0,0  ,15840,
(3201009002/IF/IAY/1420416),Construction of IAY House -IAY REG. NO. WB1255180 ,02/07/2018 ,16200 ,0 ,16020 ,0 ,13/08/2017,16020,0,0,0,0  ,16020,
(3201009002/IF/IAY/3243899),Construction of PMAY-G House for Individuals -PMAY-G  REG. NO. WB1619019 ,17/09/2021 ,18360 ,0 ,16999 ,0 ,26/11/2019,16999,0,0,0,0  ,16999,
(3201009002/IF/IAY/1325702),Construction of IAY House -IAY REG. NO. WB2285715 ,03/07/2018 ,16200 ,0 ,15840 ,0 ,04/04/2017,15840,0,0,0,0  ,15840,
(3201009002/IF/IAY/3244087),Construction of PMAY-G House for Individuals -PMAY-G  REG. NO. WB2640483 ,17/09/2021 ,18360 ,0 ,17190 ,0 ,06/12/2019,17190,0,0,0,0  ,17190,
(3201009002/IF/IAY/1338581),Construction of IAY House -IAY REG. NO. WB2278940 ,03/07/2018 ,16200 ,0 ,15840 ,0 ,31/03/2017,15840,0,0,0,0  ,15840,
(3201009002/IF/IAY/1325676),Construction of IAY House -IAY REG. NO. WB2280204 ,03/07/2018 ,16200 ,0 ,15840 ,0 ,09/04/2017,15840,0,0,0,0  ,15840,
(3201009002/IF/IAY/1325709),Construction of IAY House -IAY REG. NO. WB2289506 ,03/07/2018 ,16200 ,0 ,15840 ,0 ,31/03/2017,15840,0,0,0,0  ,15840,
(3201009002/IF/IAY/1316675),Construction of IAY House -IAY REG. NO. WB2657445 ,03/07/2018 ,16200 ,0 ,15840 ,0 ,04/04/2017,15840,0,0,0,0  ,15840,
(3201009002/IF/IAY/3244050),Construction of PMAY-G House for Individuals -PMAY-G  REG. NO. WB4614122 ,17/09/2021 ,18360 ,0 ,17190 ,0 ,26/11/2019,17190,0,0,0,0  ,17190,
(3201009002/IF/IAY/1315866),Construction of IAY House -IAY REG. NO. WB2320917 ,05/07/2018 ,16200 ,0 ,16720 ,0 ,31/03/2017,16720,0,0,0,0  ,16720,
(3201009002/IF/IAY/1315797),Construction of IAY House -IAY REG. NO. WB2307893 ,03/07/2018 ,16200 ,0 ,14960 ,0 ,31/03/2017,14960,0,0,0,0  ,14960,
(3201009002/IF/IAY/1320922),Construction of IAY House -IAY REG. NO. WB1187436 ,16/07/2018 ,16200 ,0 ,16896 ,0 ,29/03/2017,16896,0,0,0,0  ,16896,
(3201009002/IF/IAY/3243904),Construction of PMAY-G House for Individuals -PMAY-G  REG. NO. WB1943461 ,02/07/2020 ,18360 ,0 ,17190 ,0 ,06/12/2019,17190,0,0,0,0  ,17190,
(3201009002/IF/IAY/3243863),Construction of PMAY-G House for Individuals -PMAY-G  REG. NO. WB4861496 ,02/07/2020 ,18360 ,0 ,17190 ,0 ,28/11/2019,17190,0,0,0,0  ,17190,
(3201009002/IF/IAY/3243910),Construction of PMAY-G House for Individuals -PMAY-G  REG. NO. WB1945762 ,09/07/2020 ,18360 ,0 ,17190 ,0 ,26/11/2019,17190,0,0,0,0  ,17190,
(3201009002/IF/IAY/3243850),Construction of PMAY-G House for Individuals -PMAY-G  REG. NO. WB2678267 ,02/07/2020 ,18360 ,0 ,17190 ,0 ,06/12/2019,17190,0,0,0,0  ,17190,
(3201009002/IF/IAY/3243840),Construction of PMAY-G House for Individuals -PMAY-G  REG. NO. WB2176163 ,09/07/2020 ,18360 ,0 ,17190 ,0 ,28/11/2019,17190,0,0,0,0  ,17190,
(3201009002/IF/IAY/3243827),Construction of PMAY-G House for Individuals -PMAY-G  REG. NO. WB1604687 ,02/07/2020 ,18360 ,0 ,17190 ,0 ,26/11/2019,17190,0,0,0,0  ,17190,
(3201009002/IF/IAY/3243851),Construction of PMAY-G House for Individuals -PMAY-G  REG. NO. WB2318875 ,10/09/2020 ,18360 ,0 ,16999 ,0 ,26/11/2019,16999,0,0,0,0  ,16999,
(3201009002/IF/IAY/3243809),Construction of PMAY-G House for Individuals -PMAY-G  REG. NO. WB2187439 ,02/07/2020 ,18360 ,0 ,17190 ,0 ,28/11/2019,17190,0,0,0,0  ,17190,
(3201009002/IF/IAY/3243929),Construction of PMAY-G House for Individuals -PMAY-G  REG. NO. WB1582416 ,17/09/2021 ,18360 ,0 ,17190 ,0 ,26/11/2019,17190,0,0,0,0  ,17190,
(3201009002/IF/IAY/3243811),Construction of PMAY-G House for Individuals -PMAY-G  REG. NO. WB1529049 ,02/07/2020 ,18360 ,0 ,17190 ,0 ,26/11/2019,17190,0,0,0,0  ,17190,
(3201009002/IF/IAY/3243778),Construction of PMAY-G House for Individuals -PMAY-G  REG. NO. WB2177249 ,02/07/2020 ,18360 ,0 ,17190 ,0 ,28/11/2019,17190,0,0,0,0  ,17190,
(3201009002/IF/IAY/3243780),Construction of PMAY-G House for Individuals -PMAY-G  REG. NO. WB2188322 ,09/07/2020 ,18360 ,0 ,17190 ,0 ,28/11/2019,17190,0,0,0,0  ,17190,
(3201009002/IF/IAY/3243751),Construction of PMAY-G House for Individuals -PMAY-G  REG. NO. WB4152560 ,10/09/2020 ,18360 ,0 ,16808 ,0 ,26/11/2019,16808,0,0,0,0  ,16808,
(3201009002/IF/IAY/3243807),Construction of PMAY-G House for Individuals -PMAY-G  REG. NO. WB2193304 ,09/07/2020 ,18360 ,0 ,17190 ,0 ,28/11/2019,17190,0,0,0,0  ,17190,
(3201009002/IF/IAY/3243739),Construction of PMAY-G House for Individuals -PMAY-G  REG. NO. WB3049359 ,02/07/2020 ,18360 ,0 ,17190 ,0 ,26/11/2019,17190,0,0,0,0  ,17190,
(3201009002/IF/IAY/4637106),Construction of PMAY-G House for Individuals -PMAY-G  REG. NO. WB4767216 ,15/07/2022 ,20070 ,0 ,19620 ,0 ,03/01/2021,19620,0,0,0,0  ,19620,
(3201009002/IF/IAY/3243740),Construction of PMAY-G House for Individuals -PMAY-G  REG. NO. WB1552908 ,02/07/2020 ,18360 ,0 ,17190 ,0 ,26/11/2019,17190,0,0,0,0  ,17190,
(3201009002/IF/IAY/3243723),Construction of PMAY-G House for Individuals -PMAY-G  REG. NO. WB1626171 ,09/07/2020 ,18360 ,0 ,17190 ,0 ,26/11/2019,17190,0,0,0,0  ,17190,
(3201009002/IF/IAY/4637097),Construction of PMAY-G House for Individuals -PMAY-G  REG. NO. WB3633616 ,15/07/2022 ,20070 ,0 ,19620 ,0 ,03/01/2021,19620,0,0,0,0  ,19620,
(3201009002/IF/IAY/1316572),Construction of IAY House -IAY REG. NO. WB2590700 ,10/07/2018 ,16200 ,0 ,15840 ,0 ,04/04/2017,15840,0,0,0,0  ,15840,
(3201009002/IF/IAY/4637093),Construction of PMAY-G House for Individuals -PMAY-G  REG. NO. WB3041977 ,15/07/2022 ,20070 ,0 ,19620 ,0 ,03/01/2021,19620,0,0,0,0  ,19620,
(3201009002/IF/IAY/3243885),Construction of PMAY-G House for Individuals -PMAY-G  REG. NO. WB2172758 ,09/07/2020 ,18360 ,0 ,17190 ,0 ,28/11/2019,17190,0,0,0,0  ,17190,
(3201009002/IF/IAY/4637091),Construction of PMAY-G House for Individuals -PMAY-G  REG. NO. WB2561776 ,15/07/2022 ,20070 ,0 ,19407 ,0 ,03/01/2021,19407,0,0,0,0  ,19407,
(3201009002/IF/IAY/3243703),Construction of PMAY-G House for Individuals -PMAY-G  REG. NO. WB4931600 ,02/07/2020 ,18360 ,0 ,17190 ,0 ,26/11/2019,17190,0,0,0,0  ,17190,
(3201009002/IF/IAY/4637089),Construction of PMAY-G House for Individuals -PMAY-G  REG. NO. WB1913861 ,15/07/2022 ,20070 ,0 ,19620 ,0 ,03/01/2021,19620,0,0,0,0  ,19620,
(3201009002/IF/IAY/3243822),Construction of PMAY-G House for Individuals -PMAY-G  REG. NO. WB1618942 ,02/07/2020 ,18360 ,0 ,17190 ,0 ,26/11/2019,17190,0,0,0,0  ,17190,
(3201009002/IF/IAY/4637088),Construction of PMAY-G House for Individuals -PMAY-G  REG. NO. WB1014226 ,15/07/2022 ,20070 ,0 ,19620 ,0 ,03/01/2021,19620,0,0,0,0  ,19620,
(3201009002/IF/IAY/4637086),Construction of PMAY-G House for Individuals -PMAY-G  REG. NO. WB4848476 ,15/07/2022 ,20070 ,0 ,19620 ,0 ,02/01/2021,19620,0,0,0,0  ,19620,
(3201009002/IF/IAY/3243755),Construction of PMAY-G House for Individuals -PMAY-G  REG. NO. WB1578182 ,02/07/2020 ,18360 ,0 ,17190 ,0 ,26/11/2019,17190,0,0,0,0  ,17190,
(3201009002/IF/IAY/4637084),Construction of PMAY-G House for Individuals -PMAY-G  REG. NO. WB2718019 ,15/07/2022 ,20070 ,0 ,19620 ,0 ,02/01/2021,19620,0,0,0,0  ,19620,
(3201009002/IF/IAY/3243858),Construction of PMAY-G House for Individuals -PMAY-G  REG. NO. WB2272980 ,02/07/2020 ,18360 ,0 ,17190 ,0 ,26/11/2019,17190,0,0,0,0  ,17190,
(3201009002/IF/IAY/4637083),Construction of PMAY-G House for Individuals -PMAY-G  REG. NO. WB2320140 ,15/07/2022 ,20070 ,0 ,19770 ,0 ,02/01/2021,19770,0,0,0,0  ,19770,
(3201009002/IF/IAY/3243724),Construction of PMAY-G House for Individuals -PMAY-G  REG. NO. WB1602949 ,02/07/2020 ,18360 ,0 ,17190 ,0 ,26/11/2019,17190,0,0,0,0  ,17190,
(3201009002/IF/IAY/4637079),Construction of PMAY-G House for Individuals -PMAY-G  REG. NO. WB3490845 ,15/07/2022 ,20070 ,0 ,19770 ,0 ,30/12/2020,19770,0,0,0,0  ,19770,
(3201009002/IF/IAY/4637082),Construction of PMAY-G House for Individuals -PMAY-G  REG. NO. WB3968777 ,15/07/2022 ,20070 ,0 ,19620 ,0 ,30/12/2020,19620,0,0,0,0  ,19620,
(3201009002/IF/IAY/4637081),Construction of PMAY-G House for Individuals -PMAY-G  REG. NO. WB3804362 ,15/07/2022 ,20070 ,0 ,19407 ,0 ,30/12/2020,19407,0,0,0,0  ,19407,
(3201009002/IF/IAY/4637085),Construction of PMAY-G House for Individuals -PMAY-G  REG. NO. WB3867823 ,15/07/2022 ,20070 ,0 ,19620 ,0 ,02/01/2021,19620,0,0,0,0  ,19620,
(3201009002/IF/IAY/4637074),Construction of PMAY-G House for Individuals -PMAY-G  REG. NO. WB2597892 ,15/07/2022 ,20070 ,0 ,19620 ,0 ,30/12/2020,19620,0,0,0,0  ,19620,
(3201009002/IF/IAY/4637090),Construction of PMAY-G House for Individuals -PMAY-G  REG. NO. WB2470049 ,23/06/2022 ,20070 ,0 ,19770 ,0 ,03/01/2021,19770,0,0,0,0  ,19770,
(3201009002/IF/IAY/4637067),Construction of PMAY-G House for Individuals -PMAY-G  REG. NO. WB5296881 ,15/07/2022 ,20070 ,0 ,19620 ,0 ,29/12/2020,19620,0,0,0,0  ,19620,
(3201009002/IF/IAY/4637092),Construction of PMAY-G House for Individuals -PMAY-G  REG. NO. WB2630237 ,15/07/2022 ,20070 ,0 ,19620 ,0 ,03/01/2021,19620,0,0,0,0  ,19620,
(3201009002/IF/IAY/4637066),Construction of PMAY-G House for Individuals -PMAY-G  REG. NO. WB4943085 ,15/07/2022 ,20070 ,0 ,19620 ,0 ,29/12/2020,19620,0,0,0,0  ,19620,
(3201009002/IF/IAY/4637065),Construction of PMAY-G House for Individuals -PMAY-G  REG. NO. WB4918712 ,15/07/2022 ,20070 ,0 ,19620 ,0 ,29/12/2020,19620,0,0,0,0  ,19620,
(3201009002/IF/IAY/4637070),Construction of PMAY-G House for Individuals -PMAY-G  REG. NO. WB2772117 ,15/07/2022 ,20070 ,0 ,19620 ,0 ,30/12/2020,19620,0,0,0,0  ,19620,
(3201009002/IF/IAY/3243891),Construction of PMAY-G House for Individuals -PMAY-G  REG. NO. WB2167954 ,17/09/2021 ,18360 ,0 ,16999 ,0 ,28/11/2019,16999,0,0,0,0  ,16999,
(3201009002/IF/IAY/3243881),Construction of PMAY-G House for Individuals -PMAY-G  REG. NO. WB1587738 ,17/09/2021 ,18360 ,0 ,14586 ,0 ,26/11/2019,14586,0,0,0,0  ,14586,
(3201009002/IF/IAY/4637096),Construction of PMAY-G House for Individuals -PMAY-G  REG. NO. WB3491209 ,23/06/2022 ,20070 ,0 ,19407 ,0 ,03/01/2021,19407,0,0,0,0  ,19407,
(3201009002/IF/IAY/4637064),Construction of PMAY-G House for Individuals -PMAY-G  REG. NO. WB4516208 ,15/07/2022 ,20070 ,0 ,19620 ,0 ,29/12/2020,19620,0,0,0,0  ,19620,
(3201009002/IF/IAY/4637075),Construction of PMAY-G House for Individuals -PMAY-G  REG. NO. WB2694798 ,15/07/2022 ,20070 ,0 ,19620 ,0 ,30/12/2020,19620,0,0,0,0  ,19620,
(3201009002/IF/IAY/3243871),Construction of PMAY-G House for Individuals -PMAY-G  REG. NO. WB2168933 ,17/09/2021 ,18360 ,0 ,17190 ,0 ,28/11/2019,17190,0,0,0,0  ,17190,
(3201009002/IF/IAY/4637072),Construction of PMAY-G House for Individuals -PMAY-G  REG. NO. WB5262784 ,15/07/2022 ,20070 ,0 ,19620 ,0 ,30/12/2020,19620,0,0,0,0  ,19620,
(3201009002/IF/IAY/3243830),Construction of PMAY-G House for Individuals -PMAY-G  REG. NO. WB3065663 ,17/09/2021 ,18360 ,0 ,16999 ,0 ,26/11/2019,16999,0,0,0,0  ,16999,
(3201009002/IF/IAY/3243859),Construction of PMAY-G House for Individuals -PMAY-G  REG. NO. WB2155767 ,17/09/2021 ,18360 ,0 ,17190 ,0 ,28/11/2019,17190,0,0,0,0  ,17190,
(3201009002/IF/IAY/3243877),Construction of PMAY-G House for Individuals -PMAY-G  REG. NO. WB3044444 ,17/09/2021 ,18360 ,0 ,17190 ,0 ,26/11/2019,17190,0,0,0,0  ,17190,
(3201009002/IF/IAY/3243846),Construction of PMAY-G House for Individuals -PMAY-G  REG. NO. WB1642852 ,17/09/2021 ,18360 ,0 ,16999 ,0 ,26/11/2019,16999,0,0,0,0  ,16999,
(3201009002/IF/IAY/3243832),Construction of PMAY-G House for Individuals -PMAY-G  REG. NO. WB1679178 ,17/09/2021 ,18360 ,0 ,17190 ,0 ,26/11/2019,17190,0,0,0,0  ,17190,
(3201009002/IF/IAY/3243797),Construction of PMAY-G House for Individuals -PMAY-G  REG. NO. WB2153698 ,17/09/2021 ,18360 ,0 ,17190 ,0 ,28/11/2019,17190,0,0,0,0  ,17190,
(3201009002/IF/IAY/3243810),Construction of PMAY-G House for Individuals -PMAY-G  REG. NO. WB4661921 ,17/09/2021 ,18360 ,0 ,17190 ,0 ,28/11/2019,17190,0,0,0,0  ,17190,
(3201009002/IF/IAY/3243770),Construction of PMAY-G House for Individuals -PMAY-G  REG. NO. WB1969238 ,17/09/2021 ,18360 ,0 ,17190 ,0 ,28/11/2019,17190,0,0,0,0  ,17190,
(3201009002/IF/IAY/3243768),Construction of PMAY-G House for Individuals -PMAY-G  REG. NO. WB1613643 ,17/09/2021 ,18360 ,0 ,17190 ,0 ,26/11/2019,17190,0,0,0,0  ,17190,
(3201009002/IF/IAY/3243821),Construction of PMAY-G House for Individuals -PMAY-G  REG. NO. WB2188764 ,17/09/2021 ,18360 ,0 ,17190 ,0 ,28/11/2019,17190,0,0,0,0  ,17190,
(3201009002/IF/IAY/3243759),Construction of PMAY-G House for Individuals -PMAY-G  REG. NO. WB1553626 ,17/09/2021 ,18360 ,0 ,17190 ,0 ,26/11/2019,17190,0,0,0,0  ,17190,
(3201009002/IF/IAY/3243763),Construction of PMAY-G House for Individuals -PMAY-G  REG. NO. WB1964958 ,17/09/2021 ,18360 ,0 ,17190 ,0 ,28/11/2019,17190,0,0,0,0  ,17190,
(3201009002/IF/IAY/4637068),Construction of PMAY-G House for Individuals -PMAY-G  REG. NO. WB1628202 ,15/07/2022 ,20070 ,0 ,19620 ,0 ,30/12/2020,19620,0,0,0,0  ,19620,
(3201009002/IF/IAY/3243737),Construction of PMAY-G House for Individuals -PMAY-G  REG. NO. WB1620286 ,17/09/2021 ,18360 ,0 ,17190 ,0 ,26/11/2019,17190,0,0,0,0  ,17190,
(3201009002/IF/IAY/3243730),Construction of PMAY-G House for Individuals -PMAY-G  REG. NO. WB3124966 ,17/09/2021 ,18360 ,0 ,16999 ,0 ,26/11/2019,16999,0,0,0,0  ,16999,
(3201009002/IF/IAY/3243707),Construction of PMAY-G House for Individuals -PMAY-G  REG. NO. WB1621220 ,17/09/2021 ,18360 ,0 ,16999 ,0 ,26/11/2019,16999,0,0,0,0  ,16999,
(3201009002/IF/IAY/3243760),Construction of PMAY-G House for Individuals -PMAY-G  REG. NO. WB2286235 ,17/09/2021 ,18360 ,0 ,16999 ,0 ,26/11/2019,16999,0,0,0,0  ,16999,
(3201009002/IF/IAY/3243683),Construction of PMAY-G House for Individuals -PMAY-G  REG. NO. WB1938362 ,17/09/2021 ,18360 ,0 ,16999 ,0 ,26/11/2019,16999,0,0,0,0  ,16999,
(3201009002/IF/IAY/3243697),Construction of PMAY-G House for Individuals -PMAY-G  REG. NO. WB1645831 ,17/09/2021 ,18360 ,0 ,17190 ,0 ,26/11/2019,17190,0,0,0,0  ,17190,
(3201009002/IF/IAY/3243679),Construction of PMAY-G House for Individuals -PMAY-G  REG. NO. WB2273128 ,17/09/2021 ,17190 ,0 ,16999 ,0 ,26/11/2019,16999,0,0,0,0  ,16999,
(3201009002/IF/IAY/3243749),Construction of PMAY-G House for Individuals -PMAY-G  REG. NO. WB1645345 ,17/09/2021 ,18360 ,0 ,17190 ,0 ,26/11/2019,17190,0,0,0,0  ,17190,
(3201009002/IF/IAY/1315655),Construction of IAY House -IAY REG. NO. WB2283066 ,03/07/2018 ,16200 ,0 ,15840 ,0 ,31/03/2017,15840,0,0,0,0  ,15840,
(3201009002/IF/IAY/3243823),Construction of PMAY-G House for Individuals -PMAY-G  REG. NO. WB2175804 ,17/09/2021 ,18360 ,0 ,17190 ,0 ,28/11/2019,17190,0,0,0,0  ,17190,
(3201009002/IF/IAY/1315645),Construction of IAY House -IAY REG. NO. WB2281543 ,03/07/2018 ,16200 ,0 ,15840 ,0 ,29/03/2017,15840,0,0,0,0  ,15840,
(3201009002/IF/IAY/1315626),Construction of IAY House -IAY REG. NO. WB2278753 ,03/07/2018 ,16200 ,0 ,15840 ,0 ,04/04/2017,15840,0,0,0,0  ,15840,
(3201009002/IF/IAY/3243677),Construction of PMAY-G House for Individuals -PMAY-G  REG. NO. WB4698130 ,17/09/2021 ,18360 ,0 ,16617 ,0 ,26/11/2019,16617,0,0,0,0  ,16617,
(3201009002/IF/IAY/1315537),Construction of IAY House -IAY REG. NO. WB2262356 ,10/07/2018 ,16200 ,0 ,15816 ,0 ,29/03/2017,15816,0,0,0,0  ,15816,
(3201009002/IF/IAY/1315485),Construction of IAY House -IAY REG. NO. WB2254810 ,24/07/2018 ,16200 ,0 ,15840 ,0 ,29/03/2017,15840,0,0,0,0  ,15840,
(3201009002/IF/IAY/1315481),Construction of IAY House -IAY REG. NO. WB2254673 ,10/07/2018 ,16200 ,0 ,15840 ,0 ,29/03/2017,15840,0,0,0,0  ,15840,
(3201009002/IF/IAY/1311553),Construction of IAY House -IAY REG. NO. WB1379592 ,03/07/2018 ,16200 ,0 ,15840 ,0 ,04/04/2017,15840,0,0,0,0  ,15840,
(3201009002/IF/IAY/1315629),Construction of IAY House -IAY REG. NO. WB2279094 ,03/07/2018 ,16200 ,0 ,15840 ,0 ,31/03/2017,15840,0,0,0,0  ,15840,
(3201009002/IF/IAY/1315383),Construction of IAY House -IAY REG. NO. WB2237790 ,03/07/2018 ,16200 ,0 ,15840 ,0 ,29/03/2017,15840,0,0,0,0  ,15840,
(3201009002/IF/IAY/1310338),Construction of IAY House -IAY REG. NO. WB1183815 ,03/07/2018 ,16200 ,0 ,15840 ,0 ,09/02/2017,15840,0,0,0,0  ,15840,
(3201009002/IF/22012034578277),Construction of farm pond on the land of Sipai Sk at Hatdanga. ,07/05/2018 ,179100 ,13300 ,109632 ,9830 ,29/11/2017,109632,0,7830,2000,0  ,119462,
(3201009002/IF/22012034454635),Excavation of farm pond of Seher ali Mallick at Anandabas. ,07/08/2018 ,170820 ,38760 ,155610 ,11720 ,26/04/2017,155610,0,9720,2000,0  ,167330,
(3201009002/IF/22012034361498),Construction of vermi composing in the land of Mehebub Sk at Anandabas. ,27/04/2018 ,3168 ,10462 ,3168 ,1500 ,15/12/2016,3168,0,0,1500,0  ,4668,
(3201009002/IF/IAY/1056297),Construction of IAY House -IAY REG. NO. WB1350006 ,03/07/2018 ,15840 ,0 ,15840 ,0 ,15/02/2017,15840,0,0,0,0  ,15840,
(3201009002/FP/320201060426372),Plantation of vetiver on the bank side of Ganga river from the Land of Debesh Nag to the Land Bhakta ,07/05/2018 ,209520 ,26325 ,194040 ,11990 ,14/12/2017,194040,0,9990,2000,0  ,206030,
(3201009002/IF/22012034444123),Excavation of farm pond of Raju Mondal at Anandabas. ,07/05/2018 ,159480 ,37950 ,144995 ,11450 ,17/04/2017,144995,0,9450,2000,0  ,156445,
(3201009002/FP/320201060424792),Earth work in earthen bundh for flood protection on bundh from L/O Bangshi Ghosh to L/O Utpal Ghosh. ,07/05/2018 ,160380 ,12720 ,139489 ,8750 ,30/11/2017,139489,0,6750,2000,0  ,148239,
(3201009002/IF/IAY/3243720),Construction of PMAY-G House for Individuals -PMAY-G  REG. NO. WB4928119 ,17/09/2021 ,18360 ,0 ,16999 ,0 ,26/11/2019,16999,0,0,0,0  ,16999,
(3201009002/FP/130717723939),Construction of pucca drain from the h/o Narayan Biswas to H/P Nirmal kanjilal at bhaluka. ,27/04/2018 ,17248 ,170903 ,14960 ,2500 ,09/02/2017,14960,0,0,2500,0  ,17460,
(3201009002/FP/320201060422643),Plantation of vetiver on the both side of the bundh from the L/O Mantu Ghosh to Barowari tala at Ha. ,07/05/2018 ,209520 ,25325 ,181620 ,9020 ,14/07/2017,181620,0,7020,2000,0  ,190640,
(3201009002/FP/130717723856),Construction of Culvert beween the road Anandabas DangaPara to Chhatimtala including earthten work . ,27/04/2018 ,13200 ,148491 ,11440 ,3028 ,09/02/2017,11440,0,528,2500,0  ,14468,
(3201009002/IF/IAY/3243775),Construction of PMAY-G House for Individuals -PMAY-G  REG. NO. WB3052266 ,17/09/2021 ,18360 ,0 ,17190 ,0 ,26/11/2019,17190,0,0,0,0  ,17190,
(3201009002/DP/22012034312829),51 Estimate for nursery work for prepration of forestry sedding of Maa Ganga SHG un Bhaluka Gp. ,27/04/2018 ,102080 ,61516 ,87648 ,3960 ,12/09/2016,87648,0,3960,0,0  ,91608,
(3201009002/IF/IAY/3243688),Construction of PMAY-G House for Individuals -PMAY-G  REG. NO. WB1927462 ,02/07/2020 ,18360 ,0 ,17190 ,0 ,26/11/2019,17190,0,0,0,0  ,17190,
(3201009002/IF/IAY/3243686),Construction of PMAY-G House for Individuals -PMAY-G  REG. NO. WB1600565 ,02/07/2020 ,18360 ,0 ,17190 ,0 ,26/11/2019,17190,0,0,0,0  ,17190,
(3201009002/AV/34040929907),35 Construction of Anganwadi center of hatdanga ICDS at hatdanga under Bhaluka GP. ,27/04/2018 ,38192 ,470444 ,31680 ,0 ,09/08/2016,31680,0,0,0,0  ,31680,
(3201009002/IF/IAY/3243657),Construction of PMAY-G House for Individuals -PMAY-G  REG. NO. WB3946593 ,02/07/2020 ,18360 ,0 ,17190 ,0 ,26/11/2019,17190,0,0,0,0  ,17190,
(3201009002/IF/IAY/3243684),Construction of PMAY-G House for Individuals -PMAY-G  REG. NO. WB1633879 ,09/07/2020 ,18360 ,0 ,17190 ,0 ,26/11/2019,17190,0,0,0,0  ,17190,
(3201009002/IF/IAY/3243614),Construction of PMAY-G House for Individuals -PMAY-G  REG. NO. WB1523564 ,02/07/2020 ,18360 ,0 ,17190 ,0 ,26/11/2019,17190,0,0,0,0  ,17190,
(3201009002/IF/IAY/3243612),Construction of PMAY-G House for Individuals -PMAY-G  REG. NO. WB1946041 ,09/07/2020 ,18360 ,0 ,17190 ,0 ,26/11/2019,17190,0,0,0,0  ,17190,
(3201009002/IF/IAY/3243607),Construction of PMAY-G House for Individuals -PMAY-G  REG. NO. WB1937042 ,09/07/2020 ,18360 ,0 ,17190 ,0 ,26/11/2019,17190,0,0,0,0  ,17190,
(3201009002/IF/IAY/3243591),Construction of PMAY-G House for Individuals -PMAY-G  REG. NO. WB2119312 ,09/07/2020 ,18360 ,0 ,17190 ,0 ,06/12/2019,17190,0,0,0,0  ,17190,
(3201009002/IF/IAY/3243572),Construction of PMAY-G House for Individuals -PMAY-G  REG. NO. WB1615584 ,02/07/2020 ,18360 ,0 ,17190 ,0 ,26/11/2019,17190,0,0,0,0  ,17190,
(3201009002/IF/IAY/4637080),Construction of PMAY-G House for Individuals -PMAY-G  REG. NO. WB3793788 ,15/07/2022 ,20070 ,0 ,19407 ,0 ,30/12/2020,19407,0,0,0,0  ,19407,
(3201009002/IF/IAY/3243667),Construction of PMAY-G House for Individuals -PMAY-G  REG. NO. WB1634991 ,09/07/2020 ,18360 ,0 ,17190 ,0 ,26/11/2019,17190,0,0,0,0  ,17190,
(3201009002/IF/IAY/3243833),Construction of PMAY-G House for Individuals -PMAY-G  REG. NO. WB4995731 ,17/09/2021 ,18360 ,0 ,16999 ,0 ,26/11/2019,16999,0,0,0,0  ,16999,
(3201009002/IF/IAY/3243571),Construction of PMAY-G House for Individuals -PMAY-G  REG. NO. WB1621304 ,02/07/2020 ,18360 ,0 ,17190 ,0 ,26/11/2019,17190,0,0,0,0  ,17190,
(3201009002/IF/IAY/3243552),Construction of PMAY-G House for Individuals -PMAY-G  REG. NO. WB1620402 ,22/07/2020 ,18360 ,0 ,16426 ,0 ,28/11/2019,16426,0,0,0,0  ,16426,
(3201009002/IF/IAY/3243537),Construction of PMAY-G House for Individuals -PMAY-G  REG. NO. WB1630342 ,02/07/2020 ,18360 ,0 ,17190 ,0 ,26/11/2019,17190,0,0,0,0  ,17190,
(3201009002/IF/IAY/3243523),Construction of PMAY-G House for Individuals -PMAY-G  REG. NO. WB2091465 ,02/07/2020 ,18360 ,0 ,17190 ,0 ,28/11/2019,17190,0,0,0,0  ,17190,
(3201009002/IF/IAY/3243493),Construction of PMAY-G House for Individuals -PMAY-G  REG. NO. WB2640615 ,02/07/2020 ,18360 ,0 ,17190 ,0 ,06/12/2019,17190,0,0,0,0  ,17190,
(3201009002/IF/IAY/3243483),Construction of PMAY-G House for Individuals -PMAY-G  REG. NO. WB1468902 ,02/07/2020 ,18360 ,0 ,17190 ,0 ,26/11/2019,17190,0,0,0,0  ,17190,
(3201009002/FP/320201060428451),Earth work for flood protection on bundh from L/O Shristi Ghosh to L/O Sadhan Ghosh at Anandabas. ,07/05/2018 ,264240 ,19200 ,247405 ,18740 ,18/01/2018,247405,0,16740,2000,0  ,266145,
(3201009002/IF/IAY/3243447),Construction of PMAY-G House for Individuals -PMAY-G  REG. NO. WB4037734 ,02/07/2020 ,18360 ,0 ,17190 ,0 ,26/11/2019,17190,0,0,0,0  ,17190,
(3201009002/IF/IAY/4637062),Construction of PMAY-G House for Individuals -PMAY-G  REG. NO. WB3862551 ,15/07/2022 ,20070 ,0 ,19407 ,0 ,29/12/2020,19407,0,0,0,0  ,19407,
(3201009002/IF/IAY/4637063),Construction of PMAY-G House for Individuals -PMAY-G  REG. NO. WB3870118 ,15/07/2022 ,20070 ,0 ,19407 ,0 ,29/12/2020,19407,0,0,0,0  ,19407,
(3201009002/IF/IAY/3243482),Construction of PMAY-G House for Individuals -PMAY-G  REG. NO. WB4644383 ,09/07/2020 ,18360 ,0 ,17190 ,0 ,26/11/2019,17190,0,0,0,0  ,17190,
(3201009002/IF/IAY/4637061),Construction of PMAY-G House for Individuals -PMAY-G  REG. NO. WB3852287 ,15/07/2022 ,20070 ,0 ,19407 ,0 ,29/12/2020,19407,0,0,0,0  ,19407,
(3201009002/IF/IAY/4637057),Construction of PMAY-G House for Individuals -PMAY-G  REG. NO. WB2834909 ,15/07/2022 ,20070 ,0 ,19407 ,0 ,29/12/2020,19407,0,0,0,0  ,19407,
(3201009002/IF/IAY/4636726),Construction of PMAY-G House for Individuals -PMAY-G  REG. NO. WB1921304 ,15/07/2022 ,20070 ,0 ,19407 ,0 ,29/12/2020,19407,0,0,0,0  ,19407,
(3201009002/FP/320201060425767),Earth work in earthen bundh for flood protection on bundh from H/O Basanti bairaghya to Dulal Nag. ,07/05/2018 ,117180 ,10020 ,105340 ,9020 ,06/12/2017,105340,0,7020,2000,0  ,114360,
(3201009002/IF/IAY/4636724),Construction of PMAY-G House for Individuals -PMAY-G  REG. NO. WB4905072 ,15/07/2022 ,20070 ,0 ,19620 ,0 ,29/12/2020,19620,0,0,0,0  ,19620,
(3201009002/IF/IAY/4636723),Construction of PMAY-G House for Individuals -PMAY-G  REG. NO. WB4840771 ,15/07/2022 ,20070 ,0 ,19620 ,0 ,29/12/2020,19620,0,0,0,0  ,19620,
(3201009002/IF/IAY/4636722),Construction of PMAY-G House for Individuals -PMAY-G  REG. NO. WB4770873 ,15/07/2022 ,20070 ,0 ,19620 ,0 ,29/12/2020,19620,0,0,0,0  ,19620,
(3201009002/IF/IAY/4636721),Construction of PMAY-G House for Individuals -PMAY-G  REG. NO. WB3869885 ,15/07/2022 ,20070 ,0 ,19620 ,0 ,29/12/2020,19620,0,0,0,0  ,19620,
(3201009002/IF/IAY/4636720),Construction of PMAY-G House for Individuals -PMAY-G  REG. NO. WB3862216 ,15/07/2022 ,20070 ,0 ,19620 ,0 ,29/12/2020,19620,0,0,0,0  ,19620,
(3201009002/IF/IAY/4636718),Construction of PMAY-G House for Individuals -PMAY-G  REG. NO. WB3841459 ,15/07/2022 ,20070 ,0 ,19620 ,0 ,29/12/2020,19620,0,0,0,0  ,19620,
(3201009002/IF/IAY/4636716),Construction of PMAY-G House for Individuals -PMAY-G  REG. NO. WB3784808 ,15/07/2022 ,20070 ,0 ,19770 ,0 ,29/12/2020,19770,0,0,0,0  ,19770,
(3201009002/IF/IAY/4636715),Construction of PMAY-G House for Individuals -PMAY-G  REG. NO. WB3768115 ,15/06/2022 ,20070 ,0 ,19470 ,0 ,29/12/2020,19470,0,0,0,0  ,19470,
(3201009002/IF/IAY/4636725),Construction of PMAY-G House for Individuals -PMAY-G  REG. NO. WB1402764 ,15/07/2022 ,20070 ,0 ,19407 ,0 ,29/12/2020,19407,0,0,0,0  ,19407,
(3201009002/IF/IAY/4636711),Construction of PMAY-G House for Individuals -PMAY-G  REG. NO. WB3670571 ,15/07/2022 ,20070 ,0 ,19620 ,0 ,29/12/2020,19620,0,0,0,0  ,19620,
(3201009002/IF/IAY/3243541),Construction of PMAY-G House for Individuals -PMAY-G  REG. NO. WB1585707 ,02/07/2020 ,18360 ,0 ,17190 ,0 ,26/11/2019,17190,0,0,0,0  ,17190,
(3201009002/IF/IAY/4636713),Construction of PMAY-G House for Individuals -PMAY-G  REG. NO. WB3723721 ,15/07/2022 ,20070 ,0 ,19620 ,0 ,29/12/2020,19620,0,0,0,0  ,19620,
(3201009002/IF/IAY/1311883),Construction of IAY House -IAY REG. NO. WB1460961 ,03/07/2018 ,16200 ,0 ,15840 ,0 ,29/03/2017,15840,0,0,0,0  ,15840,
(3201009002/IF/IAY/3243671),Construction of PMAY-G House for Individuals -PMAY-G  REG. NO. WB2155773 ,17/09/2021 ,18360 ,0 ,17190 ,0 ,28/11/2019,17190,0,0,0,0  ,17190,
(3201009002/IF/IAY/3243664),Construction of PMAY-G House for Individuals -PMAY-G  REG. NO. WB4039569 ,17/09/2021 ,18360 ,0 ,16999 ,0 ,26/11/2019,16999,0,0,0,0  ,16999,
(3201009002/IF/IAY/4636712),Construction of PMAY-G House for Individuals -PMAY-G  REG. NO. WB3723683 ,15/07/2022 ,20070 ,0 ,19620 ,0 ,29/12/2020,19620,0,0,0,0  ,19620,
(3201009002/IF/IAY/3243643),Construction of PMAY-G House for Individuals -PMAY-G  REG. NO. WB1633887 ,17/09/2021 ,18360 ,0 ,16999 ,0 ,26/11/2019,16999,0,0,0,0  ,16999,
(3201009002/IF/IAY/3243638),Construction of PMAY-G House for Individuals -PMAY-G  REG. NO. WB1996894 ,17/09/2021 ,18360 ,0 ,17190 ,0 ,28/11/2019,17190,0,0,0,0  ,17190,
(3201009002/IF/IAY/3243642),Construction of PMAY-G House for Individuals -PMAY-G  REG. NO. WB1942406 ,17/09/2021 ,18360 ,0 ,17190 ,0 ,26/11/2019,17190,0,0,0,0  ,17190,
(3201009002/IF/IAY/3243624),Construction of PMAY-G House for Individuals -PMAY-G  REG. NO. WB2151318 ,17/09/2021 ,18360 ,0 ,17190 ,0 ,28/11/2019,17190,0,0,0,0  ,17190,
(3201009002/IF/IAY/3243649),Construction of PMAY-G House for Individuals -PMAY-G  REG. NO. WB2193944 ,17/09/2021 ,18360 ,0 ,16999 ,0 ,28/11/2019,16999,0,0,0,0  ,16999,
(3201009002/IF/IAY/3243672),Construction of PMAY-G House for Individuals -PMAY-G  REG. NO. WB1969269 ,17/09/2021 ,18360 ,0 ,17190 ,0 ,28/11/2019,17190,0,0,0,0  ,17190,
(3201009002/IF/IAY/4636710),Construction of PMAY-G House for Individuals -PMAY-G  REG. NO. WB3632083 ,15/07/2022 ,20070 ,0 ,19620 ,0 ,29/12/2020,19620,0,0,0,0  ,19620,
(3201009002/IF/IAY/4637059),Construction of PMAY-G House for Individuals -PMAY-G  REG. NO. WB2936705 ,15/07/2022 ,20070 ,0 ,19407 ,0 ,29/12/2020,19407,0,0,0,0  ,19407,
(3201009002/IF/IAY/3243604),Construction of PMAY-G House for Individuals -PMAY-G  REG. NO. WB2167127 ,17/09/2021 ,18360 ,0 ,16999 ,0 ,28/11/2019,16999,0,0,0,0  ,16999,
(3201009002/IF/IAY/3243519),Construction of PMAY-G House for Individuals -PMAY-G  REG. NO. WB1588999 ,02/07/2020 ,18360 ,0 ,17190 ,0 ,26/11/2019,17190,0,0,0,0  ,17190,
(3201009002/IF/IAY/3243582),Construction of PMAY-G House for Individuals -PMAY-G  REG. NO. WB5372305 ,17/09/2021 ,18360 ,0 ,16999 ,0 ,26/11/2019,16999,0,0,0,0  ,16999,
(3201009002/IF/IAY/3243598),Construction of PMAY-G House for Individuals -PMAY-G  REG. NO. WB1640653 ,17/09/2021 ,18360 ,0 ,16999 ,0 ,26/11/2019,16999,0,0,0,0  ,16999,
(3201009002/IF/IAY/3243549),Construction of PMAY-G House for Individuals -PMAY-G  REG. NO. WB2172799 ,17/09/2021 ,18360 ,0 ,14898 ,0 ,28/11/2019,14898,0,0,0,0  ,14898,
(3201009002/IF/IAY/3243613),Construction of PMAY-G House for Individuals -PMAY-G  REG. NO. WB4943547 ,17/09/2021 ,18360 ,0 ,16999 ,0 ,26/11/2019,16999,0,0,0,0  ,16999,
(3201009002/IF/IAY/3243544),Construction of PMAY-G House for Individuals -PMAY-G  REG. NO. WB1663286 ,17/09/2021 ,18360 ,0 ,17190 ,0 ,26/11/2019,17190,0,0,0,0  ,17190,
(3201009002/IF/IAY/3243524),Construction of PMAY-G House for Individuals -PMAY-G  REG. NO. WB1567686 ,17/09/2021 ,18360 ,0 ,17190 ,0 ,26/11/2019,17190,0,0,0,0  ,17190,
(3201009002/AV/34040929464),55 Construction AWC of Satkuluiya under Bhaluka GP. ,27/04/2018 ,38192 ,470444 ,27456 ,1584 ,24/11/2016,27456,0,1584,0,0  ,29040,
(3201009002/IF/IAY/3243564),Construction of PMAY-G House for Individuals -PMAY-G  REG. NO. WB1653885 ,17/09/2021 ,18360 ,0 ,16999 ,0 ,26/11/2019,16999,0,0,0,0  ,16999,
(3201009002/IF/IAY/3243634),Construction of PMAY-G House for Individuals -PMAY-G  REG. NO. WB5746043 ,17/09/2021 ,18360 ,0 ,16999 ,0 ,26/11/2019,16999,0,0,0,0  ,16999,
(3201009002/IF/IAY/2162059),Construction of PMAY-G House for Individuals -PMAY-G  REG. NO. WB3862619 ,07/09/2020 ,17190 ,0 ,15306 ,0 ,12/02/2018,15306,0,0,0,0  ,15306,
(3201009002/IF/IAY/2283066),Construction of PMAY-G House for Individuals -PMAY-G  REG. NO. WB1483730 ,07/09/2020 ,17190 ,0 ,15306 ,0 ,05/06/2018,15306,0,0,0,0  ,15306,
(3201009002/IF/IAY/2306805),Construction of PMAY-G House for Individuals -PMAY-G  REG. NO. WB3576497 ,10/08/2020 ,17190 ,0 ,14898 ,0 ,24/01/2018,14898,0,0,0,0  ,14898,
(3201009002/IF/IAY/3243446),Construction of PMAY-G House for Individuals -PMAY-G  REG. NO. WB1577141 ,09/07/2020 ,18360 ,0 ,17190 ,0 ,26/11/2019,17190,0,0,0,0  ,17190,
(3201009002/IF/IAY/2159321),Construction of PMAY-G House for Individuals -PMAY-G  REG. NO. WB2258536 ,07/09/2020 ,17190 ,0 ,15115 ,0 ,24/01/2018,15115,0,0,0,0  ,15115,
(3201009002/IF/IAY/2159637),Construction of PMAY-G House for Individuals -PMAY-G  REG. NO. WB1529418 ,10/08/2020 ,17190 ,0 ,14898 ,0 ,21/02/2018,14898,0,0,0,0  ,14898,
(3201009002/IF/IAY/2158843),Construction of PMAY-G House for Individuals -PMAY-G  REG. NO. WB2807407 ,10/08/2020 ,17190 ,0 ,14898 ,0 ,24/01/2018,14898,0,0,0,0  ,14898,
(3201009002/IF/IAY/2157488),Construction of PMAY-G House for Individuals -PMAY-G  REG. NO. WB1483784 ,25/11/2020 ,17190 ,0 ,16845 ,0 ,12/02/2018,16845,0,0,0,0  ,16845,
(3201009002/IF/IAY/3243557),Construction of PMAY-G House for Individuals -PMAY-G  REG. NO. WB1948934 ,17/09/2021 ,18360 ,0 ,16999 ,0 ,28/11/2019,16999,0,0,0,0  ,16999,
(3201009002/IF/IAY/2156473),Construction of PMAY-G House for Individuals -PMAY-G  REG. NO. WB1528336 ,08/12/2020 ,17190 ,0 ,17025 ,0 ,12/02/2018,17025,0,0,0,0  ,17025,
(3201009002/IF/IAY/3243617),Construction of PMAY-G House for Individuals -PMAY-G  REG. NO. WB1944602 ,17/09/2021 ,18360 ,0 ,16999 ,0 ,26/11/2019,16999,0,0,0,0  ,16999,
(3201009002/IF/IAY/2306399),Construction of PMAY-G House for Individuals -PMAY-G  REG. NO. WB3533760 ,10/08/2020 ,17190 ,0 ,13752 ,0 ,24/01/2018,13752,0,0,0,0  ,13752,
(3201009002/IF/IAY/2156342),Construction of PMAY-G House for Individuals -PMAY-G  REG. NO. WB3704043 ,10/08/2020 ,17190 ,0 ,14898 ,0 ,12/02/2018,14898,0,0,0,0  ,14898,
(3201009002/IF/IAY/2156694),Construction of PMAY-G House for Individuals -PMAY-G  REG. NO. WB1527138 ,10/08/2020 ,17190 ,0 ,14898 ,0 ,12/02/2018,14898,0,0,0,0  ,14898,
(3201009002/IF/IAY/4636709),Construction of PMAY-G House for Individuals -PMAY-G  REG. NO. WB3593335 ,15/07/2022 ,20070 ,0 ,19620 ,0 ,29/12/2020,19620,0,0,0,0  ,19620,
(3201009002/IF/IAY/2159158),Construction of PMAY-G House for Individuals -PMAY-G  REG. NO. WB1552240 ,10/08/2020 ,17190 ,0 ,14898 ,0 ,21/02/2018,14898,0,0,0,0  ,14898,
(3201009002/IF/IAY/2152902),Construction of PMAY-G House for Individuals -PMAY-G  REG. NO. WB1546147 ,10/02/2021 ,17190 ,0 ,14325 ,0 ,21/02/2018,14325,0,0,0,0  ,14325,
(3201009002/IF/IAY/4636705),Construction of PMAY-G House for Individuals -PMAY-G  REG. NO. WB2837389 ,15/07/2022 ,20070 ,0 ,19620 ,0 ,29/12/2020,19620,0,0,0,0  ,19620,
(3201009002/IF/IAY/2161400),Construction of PMAY-G House for Individuals -PMAY-G  REG. NO. WB1546381 ,10/08/2020 ,17190 ,0 ,14898 ,0 ,21/02/2018,14898,0,0,0,0  ,14898,
(3201009002/IF/IAY/4636702),Construction of PMAY-G House for Individuals -PMAY-G  REG. NO. WB2671053 ,30/06/2022 ,20070 ,0 ,19620 ,0 ,29/12/2020,19620,0,0,0,0  ,19620,
(3201009002/IF/IAY/4636703),Construction of PMAY-G House for Individuals -PMAY-G  REG. NO. WB2683299 ,30/06/2022 ,20070 ,0 ,19620 ,0 ,29/12/2020,19620,0,0,0,0  ,19620,
(3201009002/IF/IAY/4636700),Construction of PMAY-G House for Individuals -PMAY-G  REG. NO. WB1546318 ,30/06/2022 ,20070 ,0 ,19620 ,0 ,29/12/2020,19620,0,0,0,0  ,19620,
(3201009002/IF/IAY/4636699),Construction of PMAY-G House for Individuals -PMAY-G  REG. NO. WB5417544 ,15/07/2022 ,20070 ,0 ,19620 ,0 ,27/12/2020,19620,0,0,0,0  ,19620,
(3201009002/IF/IAY/4636707),Construction of PMAY-G House for Individuals -PMAY-G  REG. NO. WB2939486 ,15/07/2022 ,20070 ,0 ,19620 ,0 ,29/12/2020,19620,0,0,0,0  ,19620,
(3201009002/IF/IAY/2153391),Construction of PMAY-G House for Individuals -PMAY-G  REG. NO. WB1642940 ,10/08/2020 ,17190 ,0 ,15280 ,0 ,21/02/2018,15280,0,0,0,0  ,15280,
(3201009002/IF/IAY/4636697),Construction of PMAY-G House for Individuals -PMAY-G  REG. NO. WB5381571 ,30/06/2022 ,20070 ,0 ,19620 ,0 ,27/12/2020,19620,0,0,0,0  ,19620,
(3201009002/IF/IAY/4636698),Construction of PMAY-G House for Individuals -PMAY-G  REG. NO. WB5396306 ,15/07/2022 ,20070 ,0 ,19620 ,0 ,27/12/2020,19620,0,0,0,0  ,19620,
(3201009002/IF/IAY/4636704),Construction of PMAY-G House for Individuals -PMAY-G  REG. NO. WB2771971 ,15/07/2022 ,20070 ,0 ,19620 ,0 ,29/12/2020,19620,0,0,0,0  ,19620,
(3201009002/IF/IAY/4636701),Construction of PMAY-G House for Individuals -PMAY-G  REG. NO. WB2591994 ,15/07/2022 ,20070 ,0 ,19620 ,0 ,29/12/2020,19620,0,0,0,0  ,19620,
(3201009002/IF/IAY/4636695),Construction of PMAY-G House for Individuals -PMAY-G  REG. NO. WB4953611 ,15/07/2022 ,20070 ,0 ,19620 ,0 ,27/12/2020,19620,0,0,0,0  ,19620,
(3201009002/IF/IAY/4636694),Construction of PMAY-G House for Individuals -PMAY-G  REG. NO. WB4934828 ,15/06/2022 ,20070 ,0 ,19620 ,0 ,27/12/2020,19620,0,0,0,0  ,19620,
(3201009002/IF/IAY/4636691),Construction of PMAY-G House for Individuals -PMAY-G  REG. NO. WB4896779 ,15/07/2022 ,20070 ,0 ,19770 ,0 ,27/12/2020,19770,0,0,0,0  ,19770,
(3201009002/IF/IAY/4636690),Construction of PMAY-G House for Individuals -PMAY-G  REG. NO. WB4803225 ,15/07/2022 ,20070 ,0 ,19620 ,0 ,27/12/2020,19620,0,0,0,0  ,19620,
(3201009002/IF/IAY/4636688),Construction of PMAY-G House for Individuals -PMAY-G  REG. NO. WB4792027 ,15/06/2022 ,20070 ,0 ,19470 ,0 ,27/12/2020,19470,0,0,0,0  ,19470,
(3201009002/IF/IAY/4636689),Construction of PMAY-G House for Individuals -PMAY-G  REG. NO. WB4800453 ,15/07/2022 ,20070 ,0 ,19620 ,0 ,27/12/2020,19620,0,0,0,0  ,19620,
(3201009002/IF/IAY/4636696),Construction of PMAY-G House for Individuals -PMAY-G  REG. NO. WB4999716 ,15/07/2022 ,20070 ,0 ,19620 ,0 ,27/12/2020,19620,0,0,0,0  ,19620,
(3201009002/IF/IAY/4636684),Construction of PMAY-G House for Individuals -PMAY-G  REG. NO. WB4697996 ,15/07/2022 ,20070 ,0 ,19620 ,0 ,27/12/2020,19620,0,0,0,0  ,19620,
(3201009002/IF/IAY/3243522),Construction of PMAY-G House for Individuals -PMAY-G  REG. NO. WB1630399 ,17/09/2021 ,18360 ,0 ,17190 ,0 ,26/11/2019,17190,0,0,0,0  ,17190,
(3201009002/IF/IAY/2151944),Construction of PMAY-G House for Individuals -PMAY-G  REG. NO. WB1546198 ,10/08/2020 ,17190 ,0 ,14898 ,0 ,21/02/2018,14898,0,0,0,0  ,14898,
(3201009002/IF/IAY/4636685),Construction of PMAY-G House for Individuals -PMAY-G  REG. NO. WB4713150 ,15/06/2022 ,20070 ,0 ,19320 ,0 ,27/12/2020,19320,0,0,0,0  ,19320,
(3201009002/IF/IAY/3243546),Construction of PMAY-G House for Individuals -PMAY-G  REG. NO. WB1897746 ,02/07/2020 ,18360 ,0 ,17190 ,0 ,28/11/2019,17190,0,0,0,0  ,17190,
(3201009002/IF/IAY/3243518),Construction of PMAY-G House for Individuals -PMAY-G  REG. NO. WB1929932 ,17/09/2021 ,18360 ,0 ,17190 ,0 ,26/11/2019,17190,0,0,0,0  ,17190,
(3201009002/IF/IAY/4636683),Construction of PMAY-G House for Individuals -PMAY-G  REG. NO. WB4604119 ,30/06/2022 ,20070 ,0 ,19620 ,0 ,27/12/2020,19620,0,0,0,0  ,19620,
(3201009002/IF/IAY/4636687),Construction of PMAY-G House for Individuals -PMAY-G  REG. NO. WB4777965 ,15/07/2022 ,20070 ,0 ,19620 ,0 ,27/12/2020,19620,0,0,0,0  ,19620,
(3201009002/IF/IAY/3243496),Construction of PMAY-G House for Individuals -PMAY-G  REG. NO. WB4653262 ,19/06/2021 ,18360 ,0 ,17190 ,0 ,28/11/2019,17190,0,0,0,0  ,17190,
(3201009002/IF/IAY/4636693),Construction of PMAY-G House for Individuals -PMAY-G  REG. NO. WB4924158 ,30/06/2022 ,20070 ,0 ,19470 ,0 ,27/12/2020,19470,0,0,0,0  ,19470,
(3201009002/IF/IAY/4636692),Construction of PMAY-G House for Individuals -PMAY-G  REG. NO. WB4899336 ,15/06/2022 ,20070 ,0 ,19320 ,0 ,27/12/2020,19320,0,0,0,0  ,19320,
(3201009002/IF/IAY/3243468),Construction of PMAY-G House for Individuals -PMAY-G  REG. NO. WB3059713 ,19/06/2021 ,18360 ,0 ,16808 ,0 ,26/11/2019,16808,0,0,0,0  ,16808,
(3201009002/IF/IAY/3243457),Construction of PMAY-G House for Individuals -PMAY-G  REG. NO. WB1588335 ,19/06/2021 ,18360 ,0 ,17190 ,0 ,26/11/2019,17190,0,0,0,0  ,17190,
(3201009002/IF/IAY/3243473),Construction of PMAY-G House for Individuals -PMAY-G  REG. NO. WB2173418 ,19/06/2021 ,18360 ,0 ,17190 ,0 ,28/11/2019,17190,0,0,0,0  ,17190,
(3201009002/IF/IAY/3243474),Construction of PMAY-G House for Individuals -PMAY-G  REG. NO. WB1624481 ,19/06/2021 ,18360 ,0 ,17190 ,0 ,26/11/2019,17190,0,0,0,0  ,17190,
(3201009002/IF/IAY/3243488),Construction of PMAY-G House for Individuals -PMAY-G  REG. NO. WB3172613 ,19/06/2021 ,18360 ,0 ,17190 ,0 ,26/11/2019,17190,0,0,0,0  ,17190,
(3201009002/IF/IAY/3243436),Construction of PMAY-G House for Individuals -PMAY-G  REG. NO. WB2191586 ,29/05/2021 ,18360 ,0 ,15662 ,0 ,28/11/2019,15662,0,0,0,0  ,15662,
(3201009002/IF/IAY/3243444),Construction of PMAY-G House for Individuals -PMAY-G  REG. NO. WB1663100 ,29/05/2021 ,18360 ,0 ,14134 ,0 ,26/11/2019,14134,0,0,0,0  ,14134,
(3201009002/IF/IAY/3243466),Construction of PMAY-G House for Individuals -PMAY-G  REG. NO. WB2176079 ,19/06/2021 ,18360 ,0 ,17190 ,0 ,28/11/2019,17190,0,0,0,0  ,17190,
(3201009002/IF/IAY/2148420),Construction of PMAY-G House for Individuals -PMAY-G  REG. NO. WB2591103 ,10/08/2020 ,17190 ,0 ,14898 ,0 ,24/01/2018,14898,0,0,0,0  ,14898,
(3201009002/IF/IAY/1438495),Construction of IAY House -IAY REG. NO. WB1822751 ,26/11/2021 ,16200 ,0 ,13620 ,0 ,15/02/2017,13620,0,0,0,0  ,13620,
(3201009002/IF/IAY/2144703),Construction of PMAY-G House for Individuals -PMAY-G  REG. NO. WB1483748 ,10/08/2020 ,17190 ,0 ,14898 ,0 ,12/02/2018,14898,0,0,0,0  ,14898,
(3201009002/IF/IAY/3243458),Construction of PMAY-G House for Individuals -PMAY-G  REG. NO. WB4032367 ,19/06/2021 ,18360 ,0 ,17190 ,0 ,26/11/2019,17190,0,0,0,0  ,17190,
(3201009002/IF/321002040964369),Construction of Gitanjali House of the beneficiary of Sanjay Ghosh. ,16/07/2021 ,17190 ,0 ,16044 ,0 ,04/01/2019,16044,0,0,0,0  ,16044,
(3201009002/IF/IAY/2140242),Construction of PMAY-G House for Individuals -PMAY-G  REG. NO. WB1526841 ,10/08/2020 ,17190 ,0 ,14898 ,0 ,12/02/2018,14898,0,0,0,0  ,14898,
(3201009002/IF/IAY/2145558),Construction of PMAY-G House for Individuals -PMAY-G  REG. NO. WB1630540 ,10/02/2021 ,17190 ,0 ,14325 ,0 ,21/02/2018,14325,0,0,0,0  ,14325,
(3201009002/IF/IAY/3243450),Construction of PMAY-G House for Individuals -PMAY-G  REG. NO. WB2193888 ,19/06/2021 ,18360 ,0 ,17190 ,0 ,28/11/2019,17190,0,0,0,0  ,17190,
(3201009002/IF/IAY/2139968),Construction of PMAY-G House for Individuals -PMAY-G  REG. NO. WB2657910 ,10/08/2020 ,17190 ,0 ,14898 ,0 ,24/01/2018,14898,0,0,0,0  ,14898,
(3201009002/IF/IAY/3243491),Construction of PMAY-G House for Individuals -PMAY-G  REG. NO. WB3049558 ,19/06/2021 ,18360 ,0 ,17190 ,0 ,26/11/2019,17190,0,0,0,0  ,17190,
(3201009002/IF/IAY/4636681),Construction of PMAY-G House for Individuals -PMAY-G  REG. NO. WB3924656 ,15/07/2022 ,20070 ,0 ,19407 ,0 ,27/12/2020,19407,0,0,0,0  ,19407,
(3201009002/IF/IAY/2144678),Construction of PMAY-G House for Individuals -PMAY-G  REG. NO. WB1528992 ,10/08/2020 ,17190 ,0 ,14898 ,0 ,21/02/2018,14898,0,0,0,0  ,14898,
(3201009002/IF/IAY/4636682),Construction of PMAY-G House for Individuals -PMAY-G  REG. NO. WB4492276 ,30/06/2022 ,20070 ,0 ,19620 ,0 ,27/12/2020,19620,0,0,0,0  ,19620,
(3201009002/IF/IAY/2139246),Construction of PMAY-G House for Individuals -PMAY-G  REG. NO. WB2172596 ,10/08/2020 ,17190 ,0 ,14898 ,0 ,21/02/2018,14898,0,0,0,0  ,14898,
(3201009002/IF/IAY/4636676),Construction of PMAY-G House for Individuals -PMAY-G  REG. NO. WB3829990 ,15/07/2022 ,20070 ,0 ,19407 ,0 ,27/12/2020,19407,0,0,0,0  ,19407,
(3201009002/IF/IAY/4636674),Construction of PMAY-G House for Individuals -PMAY-G  REG. NO. WB3801440 ,15/07/2022 ,20070 ,0 ,19620 ,0 ,27/12/2020,19620,0,0,0,0  ,19620,
(3201009002/IF/IAY/2143475),Construction of PMAY-G House for Individuals -PMAY-G  REG. NO. WB3319418 ,10/08/2020 ,17190 ,0 ,14898 ,0 ,12/02/2018,14898,0,0,0,0  ,14898,
(3201009002/IF/IAY/4636675),Construction of PMAY-G House for Individuals -PMAY-G  REG. NO. WB3829821 ,15/07/2022 ,20070 ,0 ,19407 ,0 ,27/12/2020,19407,0,0,0,0  ,19407,
(3201009002/IF/IAY/4636449),Construction of PMAY-G House for Individuals -PMAY-G  REG. NO. WB3664673 ,15/07/2022 ,20070 ,0 ,19620 ,0 ,19/12/2020,19620,0,0,0,0  ,19620,
(3201009002/IF/IAY/3243497),Construction of PMAY-G House for Individuals -PMAY-G  REG. NO. WB4921280 ,19/06/2021 ,18360 ,0 ,17190 ,0 ,26/11/2019,17190,0,0,0,0  ,17190,
(3201009002/IF/IAY/4636448),Construction of PMAY-G House for Individuals -PMAY-G  REG. NO. WB3766897 ,15/07/2022 ,20070 ,0 ,19620 ,0 ,27/12/2020,19620,0,0,0,0  ,19620,
(3201009002/IF/IAY/4636672),Construction of PMAY-G House for Individuals -PMAY-G  REG. NO. WB3793985 ,15/07/2022 ,20070 ,0 ,19620 ,0 ,27/12/2020,19620,0,0,0,0  ,19620,
(3201009002/IF/IAY/4636445),Construction of PMAY-G House for Individuals -PMAY-G  REG. NO. WB3625914 ,15/07/2022 ,20070 ,0 ,19620 ,0 ,27/12/2020,19620,0,0,0,0  ,19620,
(3201009002/IF/IAY/4636673),Construction of PMAY-G House for Individuals -PMAY-G  REG. NO. WB3798932 ,15/07/2022 ,20070 ,0 ,19407 ,0 ,27/12/2020,19407,0,0,0,0  ,19407,
(3201009002/IF/IAY/4636444),Construction of PMAY-G House for Individuals -PMAY-G  REG. NO. WB3592596 ,15/07/2022 ,20070 ,0 ,19620 ,0 ,27/12/2020,19620,0,0,0,0  ,19620,
(3201009002/IF/IAY/4636443),Construction of PMAY-G House for Individuals -PMAY-G  REG. NO. WB3576578 ,15/07/2022 ,20070 ,0 ,19620 ,0 ,27/12/2020,19620,0,0,0,0  ,19620,
(3201009002/IF/IAY/4636441),Construction of PMAY-G House for Individuals -PMAY-G  REG. NO. WB3491349 ,15/06/2022 ,20070 ,0 ,19470 ,0 ,27/12/2020,19470,0,0,0,0  ,19470,
(3201009002/IF/IAY/4636446),Construction of PMAY-G House for Individuals -PMAY-G  REG. NO. WB3639855 ,15/07/2022 ,20070 ,0 ,19620 ,0 ,27/12/2020,19620,0,0,0,0  ,19620,
(3201009002/IF/IAY/4636679),Construction of PMAY-G House for Individuals -PMAY-G  REG. NO. WB3862248 ,15/07/2022 ,20070 ,0 ,19620 ,0 ,27/12/2020,19620,0,0,0,0  ,19620,
(3201009002/IF/IAY/4636442),Construction of PMAY-G House for Individuals -PMAY-G  REG. NO. WB3491483 ,15/07/2022 ,20070 ,0 ,19620 ,0 ,27/12/2020,19620,0,0,0,0  ,19620,
(3201009002/IF/IAY/4636439),Construction of PMAY-G House for Individuals -PMAY-G  REG. NO. WB3477988 ,30/06/2022 ,20070 ,0 ,19620 ,0 ,27/12/2020,19620,0,0,0,0  ,19620,
(3201009002/IF/IAY/4636437),Construction of PMAY-G House for Individuals -PMAY-G  REG. NO. WB3454608 ,15/07/2022 ,20070 ,0 ,19620 ,0 ,27/12/2020,19620,0,0,0,0  ,19620,
(3201009002/IF/IAY/4636436),Construction of PMAY-G House for Individuals -PMAY-G  REG. NO. WB3443350 ,15/06/2022 ,20070 ,0 ,19470 ,0 ,27/12/2020,19470,0,0,0,0  ,19470,
(3201009002/IF/IAY/2136378),Construction of PMAY-G House for Individuals -PMAY-G  REG. NO. WB1553853 ,10/08/2020 ,17190 ,0 ,14898 ,0 ,21/02/2018,14898,0,0,0,0  ,14898,
(3201009002/IF/IAY/4636447),Construction of PMAY-G House for Individuals -PMAY-G  REG. NO. WB3666865 ,15/07/2022 ,20070 ,0 ,19770 ,0 ,27/12/2020,19770,0,0,0,0  ,19770,
(3201009002/IF/IAY/2134834),Construction of PMAY-G House for Individuals -PMAY-G  REG. NO. WB2254985 ,10/08/2020 ,17190 ,0 ,14898 ,0 ,12/02/2018,14898,0,0,0,0  ,14898,
(3201009002/IF/IAY/2135924),Construction of PMAY-G House for Individuals -PMAY-G  REG. NO. WB1508987 ,10/08/2020 ,17190 ,0 ,14898 ,0 ,12/02/2018,14898,0,0,0,0  ,14898,
(3201009002/IF/IAY/2132137),Construction of PMAY-G House for Individuals -PMAY-G  REG. NO. WB2222717 ,10/08/2020 ,17190 ,0 ,14898 ,0 ,24/01/2018,14898,0,0,0,0  ,14898,
(3201009002/IF/IAY/4636677),Construction of PMAY-G House for Individuals -PMAY-G  REG. NO. WB3841475 ,15/07/2022 ,20070 ,0 ,19620 ,0 ,27/12/2020,19620,0,0,0,0  ,19620,
(3201009002/IF/IAY/1623299),Construction of IAY House -IAY REG. NO. WB2286621 ,24/08/2020 ,16200 ,0 ,16172 ,0 ,13/08/2017,16172,0,0,0,0  ,16172,
(3201009002/IF/IAY/1581286),Construction of IAY House -IAY REG. NO. WB1415621 ,24/08/2020 ,16200 ,0 ,16172 ,0 ,13/08/2017,16172,0,0,0,0  ,16172,
(3201009002/IF/321002040963864),Construction of Gatanjali house of the beneficiary Namita Biswas. ,16/07/2021 ,17190 ,0 ,17190 ,0 ,04/01/2019,17190,0,0,0,0  ,17190,
(3201009002/IF/IAY/4636440),Construction of PMAY-G House for Individuals -PMAY-G  REG. NO. WB3480704 ,15/07/2022 ,20070 ,0 ,19620 ,0 ,27/12/2020,19620,0,0,0,0  ,19620,
(3201009002/IF/IAY/2139500),Construction of PMAY-G House for Individuals -PMAY-G  REG. NO. WB1490307 ,08/12/2020 ,17190 ,0 ,16728 ,0 ,12/02/2018,16728,0,0,0,0  ,16728,
(3201009002/IF/IAY/1500446),Construction of IAY House -IAY REG. NO. WB2397806 ,24/08/2020 ,16200 ,0 ,16172 ,0 ,25/08/2017,16172,0,0,0,0  ,16172,
(3201009002/IF/IAY/4636438),Construction of PMAY-G House for Individuals -PMAY-G  REG. NO. WB3456524 ,15/07/2022 ,20070 ,0 ,19407 ,0 ,27/12/2020,19407,0,0,0,0  ,19407,
(3201009002/IF/IAY/1552393),Construction of IAY House -IAY REG. NO. WB2288756 ,24/08/2020 ,16200 ,0 ,14340 ,0 ,13/08/2017,14340,0,0,0,0  ,14340,
(3201009002/IF/IAY/4636680),Construction of PMAY-G House for Individuals -PMAY-G  REG. NO. WB3869871 ,15/07/2022 ,20070 ,0 ,19620 ,0 ,27/12/2020,19620,0,0,0,0  ,19620,
(3201009002/IF/IAY/1499528),Construction of IAY House -IAY REG. NO. WB2319620 ,24/08/2020 ,16200 ,0 ,16050 ,0 ,13/08/2017,16050,0,0,0,0  ,16050,
(3201009002/IF/IAY/1520500),Construction of IAY House -IAY REG. NO. WB3029433 ,24/08/2020 ,16200 ,0 ,14340 ,0 ,13/08/2017,14340,0,0,0,0  ,14340,
(3201009002/IF/IAY/1479757),Construction of IAY House -IAY REG. NO. WB2548740 ,24/08/2020 ,16200 ,0 ,16172 ,0 ,13/08/2017,16172,0,0,0,0  ,16172,
(3201009002/IF/IAY/1480374),Construction of IAY House -IAY REG. NO. WB2574124 ,24/08/2020 ,16200 ,0 ,16172 ,0 ,13/08/2017,16172,0,0,0,0  ,16172,
(3201009002/IF/IAY/1471186),Construction of IAY House -IAY REG. NO. WB2283436 ,24/08/2020 ,16200 ,0 ,14340 ,0 ,13/08/2017,14340,0,0,0,0  ,14340,
(3201009002/IF/IAY/1471114),Construction of IAY House -IAY REG. NO. WB2281477 ,24/08/2020 ,16200 ,0 ,12144 ,0 ,07/08/2017,12144,0,0,0,0  ,12144,
(3201009002/IF/IAY/1472521),Construction of IAY House -IAY REG. NO. WB2319977 ,24/08/2020 ,16200 ,0 ,14340 ,0 ,13/08/2017,14340,0,0,0,0  ,14340,
(3201009002/IF/IAY/4636435),Construction of PMAY-G House for Individuals -PMAY-G  REG. NO. WB3442096 ,15/07/2022 ,20070 ,0 ,19620 ,0 ,27/12/2020,19620,0,0,0,0  ,19620,
(3201009002/IF/IAY/1499057),Construction of IAY House -IAY REG. NO. WB2280227 ,24/08/2020 ,16200 ,0 ,16148 ,0 ,13/08/2017,16148,0,0,0,0  ,16148,
(3201009002/IF/IAY/4636433),Construction of PMAY-G House for Individuals -PMAY-G  REG. NO. WB2927826 ,15/07/2022 ,20070 ,0 ,19620 ,0 ,27/12/2020,19620,0,0,0,0  ,19620,
(3201009002/IF/IAY/1472624),Construction of IAY House -IAY REG. NO. WB2322591 ,24/08/2020 ,16200 ,0 ,15996 ,0 ,13/08/2017,15996,0,0,0,0  ,15996,
(3201009002/IF/IAY/4636431),Construction of PMAY-G House for Individuals -PMAY-G  REG. NO. WB2771859 ,15/07/2022 ,20070 ,0 ,19620 ,0 ,27/12/2020,19620,0,0,0,0  ,19620,
(3201009002/IF/IAY/1438056),Construction of IAY House -IAY REG. NO. WB2189760 ,24/08/2020 ,16200 ,0 ,16172 ,0 ,13/08/2017,16172,0,0,0,0  ,16172,
(3201009002/IF/IAY/1520143),Construction of IAY House -IAY REG. NO. WB3016385 ,25/08/2020 ,16200 ,0 ,11700 ,0 ,13/08/2017,11700,0,0,0,0  ,11700,
(3201009002/IF/IAY/4636432),Construction of PMAY-G House for Individuals -PMAY-G  REG. NO. WB2789548 ,15/07/2022 ,20070 ,0 ,19407 ,0 ,27/12/2020,19407,0,0,0,0  ,19407,
(3201009002/IF/IAY/4636430),Construction of PMAY-G House for Individuals -PMAY-G  REG. NO. WB2761124 ,15/07/2022 ,20070 ,0 ,19770 ,0 ,27/12/2020,19770,0,0,0,0  ,19770,
(3201009002/IF/IAY/4636428),Construction of PMAY-G House for Individuals -PMAY-G  REG. NO. WB2757856 ,15/07/2022 ,20070 ,0 ,19407 ,0 ,27/12/2020,19407,0,0,0,0  ,19407,
(3201009002/IF/IAY/4636429),Construction of PMAY-G House for Individuals -PMAY-G  REG. NO. WB2760710 ,15/06/2022 ,20070 ,0 ,19320 ,0 ,27/12/2020,19320,0,0,0,0  ,19320,
(3201009002/IF/IAY/4636424),Construction of PMAY-G House for Individuals -PMAY-G  REG. NO. WB2694875 ,15/07/2022 ,20070 ,0 ,19620 ,0 ,27/12/2020,19620,0,0,0,0  ,19620,
(3201009002/IF/IAY/4636426),Construction of PMAY-G House for Individuals -PMAY-G  REG. NO. WB2742215 ,30/06/2022 ,20070 ,0 ,19620 ,0 ,27/12/2020,19620,0,0,0,0  ,19620,
(3201009002/IF/IAY/4636423),Construction of PMAY-G House for Individuals -PMAY-G  REG. NO. WB2630230 ,15/07/2022 ,20070 ,0 ,19620 ,0 ,27/12/2020,19620,0,0,0,0  ,19620,
(3201009002/IF/IAY/4636434),Construction of PMAY-G House for Individuals -PMAY-G  REG. NO. WB3441750 ,15/06/2022 ,20070 ,0 ,19320 ,0 ,27/12/2020,19320,0,0,0,0  ,19320,
(3201009002/IF/IAY/4636418),Construction of PMAY-G House for Individuals -PMAY-G  REG. NO. WB2867591 ,15/06/2022 ,20070 ,0 ,19320 ,0 ,26/12/2020,19320,0,0,0,0  ,19320,
(3201009002/IF/IAY/1525528),Construction of IAY House -IAY REG. NO. WB3214546 ,24/08/2020 ,16200 ,0 ,16148 ,0 ,13/08/2017,16148,0,0,0,0  ,16148,
(3201009002/IF/IAY/4636416),Construction of PMAY-G House for Individuals -PMAY-G  REG. NO. WB2746555 ,15/06/2022 ,20070 ,0 ,19320 ,0 ,19/12/2020,19320,0,0,0,0  ,19320,
(3201009002/IF/IAY/4636415),Construction of PMAY-G House for Individuals -PMAY-G  REG. NO. WB2667485 ,15/06/2022 ,20070 ,0 ,19470 ,0 ,19/12/2020,19470,0,0,0,0  ,19470,
(3201009002/IF/IAY/4636419),Construction of PMAY-G House for Individuals -PMAY-G  REG. NO. WB2913839 ,15/07/2022 ,20070 ,0 ,19770 ,0 ,26/12/2020,19770,0,0,0,0  ,19770,
(3201009002/IF/IAY/4636420),Construction of PMAY-G House for Individuals -PMAY-G  REG. NO. WB2986865 ,15/07/2022 ,20070 ,0 ,19620 ,0 ,26/12/2020,19620,0,0,0,0  ,19620,
(3201009002/IF/IAY/1437949),Construction of IAY House -IAY REG. NO. WB2184795 ,24/08/2020 ,16200 ,0 ,16172 ,0 ,13/08/2017,16172,0,0,0,0  ,16172,
(3201009002/IF/IAY/4636421),Construction of PMAY-G House for Individuals -PMAY-G  REG. NO. WB4663593 ,15/07/2022 ,20070 ,0 ,19620 ,0 ,26/12/2020,19620,0,0,0,0  ,19620,
(3201009002/IF/IAY/1437799),Construction of IAY House -IAY REG. NO. WB2177785 ,24/08/2020 ,16200 ,0 ,16172 ,0 ,13/08/2017,16172,0,0,0,0  ,16172,
(3201009002/IF/IAY/1371339),Construction of IAY House -IAY REG. NO. WB1259355 ,24/08/2020 ,16200 ,0 ,12144 ,0 ,17/02/2017,12144,0,0,0,0  ,12144,
(3201009002/IF/IAY/1420044),Construction of IAY House -IAY REG. NO. WB1211878 ,24/08/2020 ,16200 ,0 ,16172 ,0 ,13/08/2017,16172,0,0,0,0  ,16172,
(3201009002/IF/IAY/1317817),Construction of IAY House -IAY REG. NO. WB3247091 ,10/08/2020 ,16200 ,0 ,4224 ,0 ,01/04/2017,4224,0,0,0,0  ,4224,
(3201009002/IF/IAY/4636427),Construction of PMAY-G House for Individuals -PMAY-G  REG. NO. WB2749598 ,15/07/2022 ,20070 ,0 ,19620 ,0 ,27/12/2020,19620,0,0,0,0  ,19620,
(3201009002/IF/IAY/1437958),Construction of IAY House -IAY REG. NO. WB2185210 ,24/08/2020 ,16200 ,0 ,16172 ,0 ,13/08/2017,16172,0,0,0,0  ,16172,
(3201009002/IF/IAY/1316776),Construction of IAY House -IAY REG. NO. WB2693936 ,10/08/2020 ,16200 ,0 ,6336 ,0 ,04/04/2017,6336,0,0,0,0  ,6336,
(3201009002/IF/IAY/1315779),Construction of IAY House -IAY REG. NO. WB2302997 ,24/08/2020 ,16200 ,0 ,12144 ,0 ,29/03/2017,12144,0,0,0,0  ,12144,
(3201009002/IF/IAY/1589126),Construction of IAY House -IAY REG. NO. WB2254580 ,24/08/2020 ,16200 ,0 ,14340 ,0 ,25/08/2017,14340,0,0,0,0  ,14340,
(3201009002/IF/IAY/1438048),Construction of IAY House -IAY REG. NO. WB2189535 ,24/08/2020 ,16200 ,0 ,16172 ,0 ,13/08/2017,16172,0,0,0,0  ,16172,
(3201009002/IF/IAY/1315188),Construction of IAY House -IAY REG. NO. WB2183764 ,24/08/2020 ,16200 ,0 ,12144 ,0 ,31/03/2017,12144,0,0,0,0  ,12144,
(3201009002/IF/IAY/1314119),Construction of IAY House -IAY REG. NO. WB1903543 ,10/08/2020 ,16200 ,0 ,7040 ,0 ,09/02/2017,7040,0,0,0,0  ,7040,
(3201009002/IF/321002041090133),Excavation of farm pond on the L/O Tancher Sekh at Anandabas ,21/07/2020 ,337043.93 ,3000 ,328675 ,11377.5 ,26/02/2020,328675,0,8381.5,2996,0  ,340052.5,
(3201009002/IF/IAY/1053679),Construction of IAY House -IAY REG. NO. WB1089694 ,24/08/2020 ,16200 ,0 ,12144 ,0 ,15/02/2017,12144,0,0,0,0  ,12144,
(3201009002/IF/IAY/1316097),Construction of IAY House -IAY REG. NO. WB2372158 ,24/08/2020 ,16200 ,0 ,15408 ,0 ,29/03/2017,15408,0,0,0,0  ,15408,
(3201009002/IF/321002041058819),EXCAVATION OF FARM POND ON THE L/O KASEM MONDAL AT ANANDABAS.1 ,14/05/2020 ,253343.12 ,3000 ,223105 ,10271 ,17/12/2019,223105,0,7275,2996,0  ,233376,
(3201009002/IF/IAY/1314430),Construction of IAY House -IAY REG. NO. WB1963376 ,10/08/2020 ,16200 ,0 ,4224 ,0 ,29/03/2017,4224,0,0,0,0  ,4224,
(3201009002/IF/321002041081677),Excavation of Farm Pond on The L/O Kaber Sekh at Anandabas. ,22/01/2021 ,337044.96 ,3000 ,337485 ,12694 ,12/02/2020,337485,0,9698,2996,0  ,350179,
(3201009002/IF/321002041000979),EXCAVATION OF FARM POND ON THE LAND OF JAMADAR SEKH AT ANANDABAS. ,14/05/2020 ,169643.03 ,3000 ,105286 ,6491 ,07/11/2019,105286,0,3495,2996,0  ,111777,
(3201009002/IF/321002041000960),EXCAVATION OF FARM POND ON THE LAND OF REJAULHAC MONDAL AT ANANDABAS. ,14/05/2020 ,139284.33 ,3000 ,130330 ,6830 ,22/10/2019,130330,0,3834,2996,0  ,137160,
(3201009002/IF/IAY/4636414),Construction of PMAY-G House for Individuals -PMAY-G  REG. NO. WB1969245 ,15/07/2022 ,20070 ,0 ,19620 ,0 ,19/12/2020,19620,0,0,0,0  ,19620,
(3201009002/IF/321002041083722),EXCAVATION OF FARM POND ON THE L/O INAT ALI AK AT ANANDABAS. ,21/07/2020 ,337043.93 ,3000 ,317385 ,11386 ,15/02/2020,317385,0,8390,2996,0  ,328771,
(3201009002/IF/IAY/4636409),Construction of PMAY-G House for Individuals -PMAY-G  REG. NO. WB5329782 ,15/07/2022 ,20070 ,0 ,19407 ,0 ,01/01/2021,19407,0,0,0,0  ,19407,
(3201009002/IF/321002041001081),EXCAVATION OF FARM POND ON THE LAND OF IYASIN SK AT ANANDABAS. ,14/05/2020 ,181253.27 ,3000 ,149440 ,7775 ,12/02/2020,149440,0,4779,2996,0  ,157215,
(3201009002/IF/IAY/4636413),Construction of PMAY-G House for Individuals -PMAY-G  REG. NO. WB3311047 ,15/07/2022 ,20070 ,0 ,19620 ,0 ,18/08/2020,19620,0,0,0,0  ,19620,
(3201009002/IF/IAY/4508119),Construction of PMAY-G House for Individuals -PMAY-G  REG. NO. WB5342175 ,15/07/2022 ,20070 ,0 ,19620 ,0 ,01/12/2020,19620,0,0,0,0  ,19620,
(3201009002/IF/IAY/4471929),Construction of PMAY-G House for Individuals -PMAY-G  REG. NO. WB3124826 ,30/06/2022 ,20070 ,0 ,19620 ,0 ,01/12/2020,19620,0,0,0,0  ,19620,
(3201009002/IF/IAY/4478761),Construction of PMAY-G House for Individuals -PMAY-G  REG. NO. WB3399595 ,15/07/2022 ,20070 ,0 ,19620 ,0 ,01/12/2020,19620,0,0,0,0  ,19620,
(3201009002/IF/IAY/4475148),Construction of PMAY-G House for Individuals -PMAY-G  REG. NO. WB3308686 ,15/07/2022 ,20070 ,0 ,19407 ,0 ,01/12/2020,19407,0,0,0,0  ,19407,
(3201009002/IF/IAY/4468870),Construction of PMAY-G House for Individuals -PMAY-G  REG. NO. WB3097087 ,15/07/2022 ,20070 ,0 ,19620 ,0 ,01/12/2020,19620,0,0,0,0  ,19620,
(3201009002/IF/IAY/4478775),Construction of PMAY-G House for Individuals -PMAY-G  REG. NO. WB3045630 ,15/06/2022 ,20070 ,0 ,19470 ,0 ,01/12/2020,19470,0,0,0,0  ,19470,
(3201009002/IF/IAY/4468634),Construction of PMAY-G House for Individuals -PMAY-G  REG. NO. WB3009147 ,15/07/2022 ,20070 ,0 ,19620 ,0 ,01/12/2020,19620,0,0,0,0  ,19620,
(3201009002/IF/IAY/4467824),Construction of PMAY-G House for Individuals -PMAY-G  REG. NO. WB1927470 ,15/07/2022 ,20070 ,0 ,19407 ,0 ,10/06/2020,19407,0,0,0,0  ,19407,
(3201009002/IF/IAY/4466378),Construction of PMAY-G House for Individuals -PMAY-G  REG. NO. WB2231196 ,15/06/2022 ,20070 ,0 ,19320 ,0 ,01/12/2020,19320,0,0,0,0  ,19320,
(3201009002/IF/IAY/4464433),Construction of PMAY-G House for Individuals -PMAY-G  REG. NO. WB1588569 ,15/07/2022 ,20070 ,0 ,19620 ,0 ,10/06/2020,19620,0,0,0,0  ,19620,
(3201009002/IF/IAY/4470412),Construction of PMAY-G House for Individuals -PMAY-G  REG. NO. WB3281696 ,15/06/2022 ,20070 ,0 ,19320 ,0 ,01/12/2020,19320,0,0,0,0  ,19320,
(3201009002/IF/IAY/4462283),Construction of PMAY-G House for Individuals -PMAY-G  REG. NO. WB1949522 ,16/07/2022 ,18360 ,0 ,19620 ,0 ,10/06/2020,19620,0,0,0,0  ,19620,
(3201009002/IF/IAY/4391942),Construction of PMAY-G House for Individuals -PMAY-G  REG. NO. WB3445482 ,15/07/2022 ,20070 ,0 ,19620 ,0 ,04/11/2020,19620,0,0,0,0  ,19620,
(3201009002/IF/IAY/4470597),Construction of PMAY-G House for Individuals -PMAY-G  REG. NO. WB3074667 ,15/07/2022 ,20070 ,0 ,19620 ,0 ,01/12/2020,19620,0,0,0,0  ,19620,
(3201009002/IF/IAY/4117760),Construction of PMAY-G House for Individuals -PMAY-G  REG. NO. WB1663060 ,20/05/2022 ,20070 ,0 ,19320 ,0 ,24/06/2020,19320,0,0,0,0  ,19320,
(3201009002/IF/IAY/4377218),Construction of PMAY-G House for Individuals -PMAY-G  REG. NO. WB2862042 ,15/07/2022 ,20070 ,0 ,19620 ,0 ,04/11/2020,19620,0,0,0,0  ,19620,
(3201009002/IF/IAY/4117705),Construction of PMAY-G House for Individuals -PMAY-G  REG. NO. WB1585591 ,10/06/2022 ,20070 ,0 ,19122 ,0 ,10/06/2020,19122,0,0,0,0  ,19122,
(3201009002/IF/321002041000922),EXCAVATION OF FROM POND ON THE LAND OF AMIR ALI MONDAL AT ANANDABAS. ,14/05/2020 ,207757.98 ,3000 ,190980 ,8984 ,16/12/2019,190980,0,5988,2996,0  ,199964,
(3201009002/IF/22012034444370),Construction of Gitanjali House of beneficiary Bhakta Dhara at Satkulia. ,07/09/2020 ,15840 ,0 ,13308 ,0 ,18/01/2017,13308,0,0,0,0  ,13308,
(3201009002/IF/22012034444333),Construction of Gitanjali House of beneficiary Manik Ghosh at Jangalbas. ,07/09/2020 ,15840 ,0 ,13356 ,0 ,18/01/2017,13356,0,0,0,0  ,13356,
(3201009002/IF/22012034444348),Construction of Gitanjali House of beneficiary Kanai Shil at Bhaluka ,24/08/2020 ,15840 ,0 ,15408 ,0 ,18/01/2017,15408,0,0,0,0  ,15408,
(3201009002/IF/IAY/4117711),Construction of PMAY-G House for Individuals -PMAY-G  REG. NO. WB3424190 ,15/05/2022 ,20070 ,0 ,18936 ,0 ,26/06/2020,18936,0,0,0,0  ,18936,
(3201009002/IF/IAY/1349215),Construction of IAY House -IAY REG. NO. WB2317710 ,24/08/2020 ,16200 ,0 ,12144 ,0 ,29/03/2017,12144,0,0,0,0  ,12144,
(3201009002/IF/22012034444313),Construction of Gitanjali House of beneficiary Tinkari Halsana at NatunPara ,07/09/2020 ,15840 ,0 ,13308 ,0 ,18/01/2017,13308,0,0,0,0  ,13308,
(3201009002/IF/22012034444293),Construction of Gitanjali House of beneficiary Nabin Biswas at Bhaluka ,24/08/2020 ,15840 ,0 ,15408 ,0 ,18/01/2017,15408,0,0,0,0  ,15408,
(3201009002/IF/IAY/4463651),Construction of PMAY-G House for Individuals -PMAY-G  REG. NO. WB2225412 ,15/07/2022 ,19170 ,0 ,19620 ,0 ,01/12/2020,19620,0,0,0,0  ,19620,
(3201009002/IF/22012034444327),Construction of Gitanjali House of beneficiary Alok Sarkar at Bhaluka ,24/08/2020 ,15840 ,0 ,15408 ,0 ,18/01/2017,15408,0,0,0,0  ,15408,
(3201009002/IF/22012034444269),Construction of Gitanjali House of beneficiary Gole Bewa Mondal at Anandabas ,24/08/2020 ,15840 ,0 ,13296 ,0 ,18/01/2017,13296,0,0,0,0  ,13296,
(3201009002/IF/22012034444281),Construction of Gitanjali House of beneficiary Bakul Sekh at Anandabas ,24/08/2020 ,15840 ,0 ,15408 ,0 ,18/01/2017,15408,0,0,0,0  ,15408,
(3201009002/IF/22012034444252),Construction of Gitanjali House of beneficiary Alok Sadhukhan at Anandabas ,24/08/2020 ,15840 ,0 ,15280 ,0 ,18/01/2017,15280,0,0,0,0  ,15280,
(3201009002/IF/22012034444240),Construction of Gitanjali House of beneficiary nasir sekh at Anandabas. ,25/11/2020 ,15840 ,0 ,16176 ,0 ,18/01/2017,16176,0,0,0,0  ,16176,
(3201009002/IF/IAY/4117658),Construction of PMAY-G House for Individuals -PMAY-G  REG. NO. WB3289895 ,12/05/2022 ,20070 ,0 ,18936 ,0 ,06/07/2020,18936,0,0,0,0  ,18936,
(3201009002/IF/22012034444288),Construction of Gitanjali House of beneficiary Nimai Biswas at Bhaluka ,07/09/2020 ,15840 ,0 ,13356 ,0 ,18/01/2017,13356,0,0,0,0  ,13356,
(3201009002/IF/22012034444285),Construction of Gitanjali House of beneficiary Keshmat Ali Sekh at Bhaluka ,07/09/2020 ,15840 ,0 ,13356 ,0 ,18/01/2017,13356,0,0,0,0  ,13356,
(3201009002/IF/IAY/4117631),Construction of PMAY-G House for Individuals -PMAY-G  REG. NO. WB2225401 ,10/06/2022 ,20070 ,0 ,19122 ,0 ,29/06/2020,19122,0,0,0,0  ,19122,
(3201009002/IF/IAY/4117623),Construction of PMAY-G House for Individuals -PMAY-G  REG. NO. WB3239595 ,10/06/2022 ,20070 ,0 ,19122 ,0 ,29/06/2020,19122,0,0,0,0  ,19122,
(3201009002/IF/IAY/4117612),Construction of PMAY-G House for Individuals -PMAY-G  REG. NO. WB3280374 ,10/06/2022 ,20070 ,0 ,19470 ,0 ,29/06/2020,19470,0,0,0,0  ,19470,
(3201009002/IF/IAY/4117522),Construction of PMAY-G House for Individuals -PMAY-G  REG. NO. WB1483836 ,15/05/2022 ,20070 ,0 ,18936 ,0 ,26/06/2020,18936,0,0,0,0  ,18936,
(3201009002/IF/22012034444257),Construction of Gitanjali House of beneficiary Ajijul mallick at Anandabas ,24/08/2020 ,15840 ,0 ,16476 ,0 ,18/01/2017,16476,0,0,0,0  ,16476,
(3201009002/IF/IAY/4117593),Construction of PMAY-G House for Individuals -PMAY-G  REG. NO. WB2548734 ,20/05/2022 ,20070 ,0 ,19320 ,0 ,29/06/2020,19320,0,0,0,0  ,19320,
(3201009002/IF/IAY/4116827),Construction of PMAY-G House for Individuals -PMAY-G  REG. NO. WB1578626 ,10/06/2022 ,20070 ,0 ,19122 ,0 ,24/06/2020,19122,0,0,0,0  ,19122,
(3201009002/IF/IAY/4116826),Construction of PMAY-G House for Individuals -PMAY-G  REG. NO. WB1595750 ,20/05/2022 ,20070 ,0 ,19320 ,0 ,10/06/2020,19320,0,0,0,0  ,19320,
(3201009002/IF/IAY/4117573),Construction of PMAY-G House for Individuals -PMAY-G  REG. NO. WB2640545 ,15/05/2022 ,20070 ,0 ,18936 ,0 ,10/06/2020,18936,0,0,0,0  ,18936,
(3201009002/IF/IAY/4116833),Construction of PMAY-G House for Individuals -PMAY-G  REG. NO. WB2193134 ,20/05/2022 ,20070 ,0 ,19320 ,0 ,24/06/2020,19320,0,0,0,0  ,19320,
(3201009002/IF/IAY/4116817),Construction of PMAY-G House for Individuals -PMAY-G  REG. NO. WB2192522 ,20/05/2022 ,20070 ,0 ,19320 ,0 ,26/06/2020,19320,0,0,0,0  ,19320,
(3201009002/IF/IAY/4116806),Construction of PMAY-G House for Individuals -PMAY-G  REG. NO. WB3433144 ,15/05/2022 ,20070 ,0 ,18946 ,0 ,24/06/2020,18946,0,0,0,0  ,18946,
(3201009002/IF/IAY/4116822),Construction of PMAY-G House for Individuals -PMAY-G  REG. NO. WB1620396 ,10/06/2022 ,20070 ,0 ,19122 ,0 ,24/06/2020,19122,0,0,0,0  ,19122,
(3201009002/IF/IAY/4116780),Construction of PMAY-G House for Individuals -PMAY-G  REG. NO. WB2889695 ,15/05/2022 ,20070 ,0 ,18936 ,0 ,10/06/2020,18936,0,0,0,0  ,18936,
(3201009002/IF/IAY/4116841),Construction of PMAY-G House for Individuals -PMAY-G  REG. NO. WB2546720 ,15/05/2022 ,20070 ,0 ,18936 ,0 ,24/06/2020,18936,0,0,0,0  ,18936,
(3201009002/IF/IAY/4116763),Construction of PMAY-G House for Individuals -PMAY-G  REG. NO. WB2782790 ,15/05/2022 ,20070 ,0 ,18936 ,0 ,10/06/2020,18936,0,0,0,0  ,18936,
(3201009002/IF/IAY/4116745),Construction of PMAY-G House for Individuals -PMAY-G  REG. NO. WB2763166 ,15/05/2022 ,20070 ,0 ,18936 ,0 ,10/06/2020,18936,0,0,0,0  ,18936,
(3201009002/IF/IAY/4116787),Construction of PMAY-G House for Individuals -PMAY-G  REG. NO. WB2180073 ,20/05/2022 ,20070 ,0 ,19330 ,0 ,29/06/2020,19330,0,0,0,0  ,19330,
(3201009002/IF/IAY/4116771),Construction of PMAY-G House for Individuals -PMAY-G  REG. NO. WB2734446 ,15/05/2022 ,20070 ,0 ,18936 ,0 ,10/06/2020,18936,0,0,0,0  ,18936,
(3201009002/IF/IAY/4116730),Construction of PMAY-G House for Individuals -PMAY-G  REG. NO. WB2895265 ,15/05/2022 ,20070 ,0 ,18936 ,0 ,10/06/2020,18936,0,0,0,0  ,18936,
(3201009002/IF/IAY/4116842),Construction of PMAY-G House for Individuals -PMAY-G  REG. NO. WB3381264 ,15/05/2022 ,20070 ,0 ,18936 ,0 ,24/06/2020,18936,0,0,0,0  ,18936,
(3201009002/IF/IAY/4116719),Construction of PMAY-G House for Individuals -PMAY-G  REG. NO. WB3416642 ,15/05/2022 ,20070 ,0 ,18936 ,0 ,29/06/2020,18936,0,0,0,0  ,18936,
(3201009002/IF/IAY/4116731),Construction of PMAY-G House for Individuals -PMAY-G  REG. NO. WB3286679 ,15/05/2022 ,20070 ,0 ,18936 ,0 ,24/06/2020,18936,0,0,0,0  ,18936,
(3201009002/IF/IAY/4116701),Construction of PMAY-G House for Individuals -PMAY-G  REG. NO. WB2650810 ,20/05/2022 ,20070 ,0 ,19320 ,0 ,24/06/2020,19320,0,0,0,0  ,19320,
(3201009002/IF/IAY/4116786),Construction of PMAY-G House for Individuals -PMAY-G  REG. NO. WB2214209 ,10/06/2022 ,20070 ,0 ,19470 ,0 ,29/06/2020,19470,0,0,0,0  ,19470,
(3201009002/IF/IAY/4116695),Construction of PMAY-G House for Individuals -PMAY-G  REG. NO. WB3303493 ,10/06/2022 ,20070 ,0 ,18661 ,0 ,29/06/2020,18661,0,0,0,0  ,18661,
(3201009002/IF/IAY/4116694),Construction of PMAY-G House for Individuals -PMAY-G  REG. NO. WB2861278 ,15/05/2022 ,20070 ,0 ,18936 ,0 ,10/06/2020,18936,0,0,0,0  ,18936,
(3201009002/IF/321002041000977),EXCAVATION OF FARM POND ON THE LAND OF JINNAT SK AT ANANDABAS. ,21/07/2020 ,337043.93 ,3000 ,266240 ,10501 ,06/03/2020,266240,0,7505,2996,0  ,276741,
(3201009002/IF/IAY/4116682),Construction of PMAY-G House for Individuals -PMAY-G  REG. NO. WB3039747 ,20/05/2022 ,20070 ,0 ,19320 ,0 ,24/06/2020,19320,0,0,0,0  ,19320,
(3201009002/IF/IAY/4116740),Construction of PMAY-G House for Individuals -PMAY-G  REG. NO. WB2711505 ,15/05/2022 ,20070 ,0 ,18936 ,0 ,10/06/2020,18936,0,0,0,0  ,18936,
(3201009002/IF/IAY/4116689),Construction of PMAY-G House for Individuals -PMAY-G  REG. NO. WB1964819 ,10/06/2022 ,20070 ,0 ,19470 ,0 ,10/06/2020,19470,0,0,0,0  ,19470,
(3201009002/IF/IAY/4116651),Construction of PMAY-G House for Individuals -PMAY-G  REG. NO. WB3397838 ,20/05/2022 ,20070 ,0 ,19320 ,0 ,24/06/2020,19320,0,0,0,0  ,19320,
(3201009002/IF/IAY/4116643),Construction of PMAY-G House for Individuals -PMAY-G  REG. NO. WB3128863 ,20/05/2022 ,20070 ,0 ,19195 ,0 ,06/07/2020,19195,0,0,0,0  ,19195,
(3201009002/IF/IAY/4116706),Construction of PMAY-G House for Individuals -PMAY-G  REG. NO. WB2222603 ,20/05/2022 ,20070 ,0 ,18982 ,0 ,29/06/2020,18982,0,0,0,0  ,18982,
(3201009002/IF/22012034444207),Contruction of Gitanjali house of the Beneficiary Habul Mondal. ,10/08/2020 ,15840 ,0 ,16008 ,0 ,18/01/2017,16008,0,0,0,0  ,16008,
(3201009002/IF/IAY/4116609),Construction of PMAY-G House for Individuals -PMAY-G  REG. NO. WB1643639 ,10/06/2022 ,20070 ,0 ,19122 ,0 ,10/06/2020,19122,0,0,0,0  ,19122,
(3201009002/IF/IAY/4116647),Construction of PMAY-G House for Individuals -PMAY-G  REG. NO. WB2091342 ,26/04/2022 ,19170 ,0 ,18822 ,0 ,26/06/2020,18822,0,0,0,0  ,18822,
(3201009002/IF/IAY/4116602),Construction of PMAY-G House for Individuals -PMAY-G  REG. NO. WB1578151 ,10/06/2022 ,20070 ,0 ,19122 ,0 ,10/06/2020,19122,0,0,0,0  ,19122,
(3201009002/IF/IAY/1315476),Construction of IAY House -IAY REG. NO. WB2253998 ,07/09/2020 ,16200 ,0 ,14208 ,0 ,29/03/2017,14208,0,0,0,0  ,14208,
(3201009002/IF/IAY/4116665),Construction of PMAY-G House for Individuals -PMAY-G  REG. NO. WB2414388 ,20/05/2022 ,20070 ,0 ,19195 ,0 ,29/06/2020,19195,0,0,0,0  ,19195,
(3201009002/IF/IAY/1423211),Construction of IAY House -IAY REG. NO. WB1482670 ,24/08/2020 ,16200 ,0 ,16172 ,0 ,13/08/2017,16172,0,0,0,0  ,16172,
(3201009002/IF/IAY/4116546),Construction of PMAY-G House for Individuals -PMAY-G  REG. NO. WB2222928 ,20/05/2022 ,20070 ,0 ,19330 ,0 ,26/06/2020,19330,0,0,0,0  ,19330,
(3201009002/IF/IAY/4116522),Construction of PMAY-G House for Individuals -PMAY-G  REG. NO. WB2785758 ,10/06/2022 ,20070 ,0 ,19122 ,0 ,10/06/2020,19122,0,0,0,0  ,19122,
(3201009002/IF/IAY/4116520),Construction of PMAY-G House for Individuals -PMAY-G  REG. NO. WB2920714 ,15/05/2022 ,20070 ,0 ,18936 ,0 ,10/06/2020,18936,0,0,0,0  ,18936,
(3201009002/IF/IAY/4116544),Construction of PMAY-G House for Individuals -PMAY-G  REG. NO. WB2159969 ,20/05/2022 ,20070 ,0 ,19320 ,0 ,26/06/2020,19320,0,0,0,0  ,19320,
(3201009002/IF/IAY/4116561),Construction of PMAY-G House for Individuals -PMAY-G  REG. NO. WB2717838 ,15/05/2022 ,20070 ,0 ,18936 ,0 ,10/06/2020,18936,0,0,0,0  ,18936,
(3201009002/IF/IAY/4116513),Construction of PMAY-G House for Individuals -PMAY-G  REG. NO. WB3248549 ,25/06/2022 ,20070 ,0 ,19407 ,0 ,29/06/2020,19407,0,0,0,0  ,19407,
(3201009002/IF/IAY/4116511),Construction of PMAY-G House for Individuals -PMAY-G  REG. NO. WB2353482 ,15/05/2022 ,20070 ,0 ,18936 ,0 ,24/06/2020,18936,0,0,0,0  ,18936,
(3201009002/IF/IAY/4116566),Construction of PMAY-G House for Individuals -PMAY-G  REG. NO. WB2498945 ,15/05/2022 ,20070 ,0 ,18936 ,0 ,24/06/2020,18936,0,0,0,0  ,18936,
(3201009002/IF/IAY/4116595),Construction of PMAY-G House for Individuals -PMAY-G  REG. NO. WB2155703 ,25/06/2022 ,20070 ,0 ,19770 ,0 ,26/06/2020,19770,0,0,0,0  ,19770,
(3201009002/IF/IAY/4116497),Construction of PMAY-G House for Individuals -PMAY-G  REG. NO. WB2783540 ,15/05/2022 ,20070 ,0 ,18936 ,0 ,10/06/2020,18936,0,0,0,0  ,18936,
(3201009002/IF/IAY/4116624),Construction of PMAY-G House for Individuals -PMAY-G  REG. NO. WB2806324 ,12/05/2022 ,20070 ,0 ,18936 ,0 ,10/06/2020,18936,0,0,0,0  ,18936,
(3201009002/IF/IAY/4116507),Construction of PMAY-G House for Individuals -PMAY-G  REG. NO. WB3425549 ,15/05/2022 ,20070 ,0 ,18936 ,0 ,29/06/2020,18936,0,0,0,0  ,18936,
(3201009002/IF/IAY/4116501),Construction of PMAY-G House for Individuals -PMAY-G  REG. NO. WB2771819 ,15/05/2022 ,20070 ,0 ,18936 ,0 ,10/06/2020,18936,0,0,0,0  ,18936,
(3201009002/IF/IAY/4116707),Construction of PMAY-G House for Individuals -PMAY-G  REG. NO. WB1969249 ,20/05/2022 ,20070 ,0 ,19320 ,0 ,26/06/2020,19320,0,0,0,0  ,19320,
(3201009002/IF/IAY/4116508),Construction of PMAY-G House for Individuals -PMAY-G  REG. NO. WB3406804 ,10/06/2022 ,20070 ,0 ,19122 ,0 ,29/06/2020,19122,0,0,0,0  ,19122,
(3201009002/IF/IAY/4116449),Construction of PMAY-G House for Individuals -PMAY-G  REG. NO. WB2780620 ,15/05/2022 ,20070 ,0 ,18936 ,0 ,10/06/2020,18936,0,0,0,0  ,18936,
(3201009002/IF/IAY/4116444),Construction of PMAY-G House for Individuals -PMAY-G  REG. NO. WB1606343 ,10/06/2022 ,20070 ,0 ,18676 ,0 ,24/06/2020,18676,0,0,0,0  ,18676,
(3201009002/IF/IAY/4116447),Construction of PMAY-G House for Individuals -PMAY-G  REG. NO. WB3037986 ,15/05/2022 ,20070 ,0 ,18936 ,0 ,10/06/2020,18936,0,0,0,0  ,18936,
(3201009002/IF/IAY/4116436),Construction of PMAY-G House for Individuals -PMAY-G  REG. NO. WB1588165 ,10/06/2022 ,20070 ,0 ,19122 ,0 ,10/06/2020,19122,0,0,0,0  ,19122,
(3201009002/IF/IAY/4116498),Construction of PMAY-G House for Individuals -PMAY-G  REG. NO. WB2909784 ,10/06/2022 ,20070 ,0 ,19470 ,0 ,10/06/2020,19470,0,0,0,0  ,19470,
(3201009002/RS/34041074897),Construction of tube well platfrom with sopk pit & compost pit at PMAY House  of Jhulekha Bewa. ,15/02/2020 ,720 ,0 ,720 ,0 ,21/11/2017,720,0,0,0,0  ,720,
(3201009002/IF/IAY/4116484),Construction of PMAY-G House for Individuals -PMAY-G  REG. NO. WB2526580 ,15/05/2022 ,20070 ,0 ,18936 ,0 ,24/06/2020,18936,0,0,0,0  ,18936,
(3201009002/RS/34041014384),68 Excavation for Garbage Pit of  ,02/07/2019 ,18304 ,6032 ,17177 ,1056 ,18/01/2017,17177,0,1056,0,0  ,18233,
(3201009002/RC/320201060417756),Construction of concrete road from the H/O  Kashem Sekh to Pucca Rasta at Bhaluka GP. ,02/07/2019 ,12600 ,214924 ,360 ,0 ,02/06/2017,360,0,0,0,0  ,360,
(3201009002/IF/IAY/983345),Construction of IAY House -IAY REG. NO. WB1915947 ,11/09/2019 ,15840 ,0 ,13728 ,0 ,09/02/2017,13728,0,0,0,0  ,13728,
(3201009002/IF/IAY/982854),Construction of IAY House -IAY REG. NO. WB1083866 ,11/09/2019 ,15840 ,0 ,8448 ,0 ,09/02/2017,8448,0,0,0,0  ,8448,
(3201009002/WC/704010330492),Excavation of farm pond of Pashupati Majhi at Sijaipur. ,03/09/2019 ,170820 ,38760 ,135628 ,11802.5 ,28/04/2017,135628,0,9802.5,2000,0  ,147430.5,
(3201009002/IF/IAY/977616),Construction of IAY House -IAY REG. NO. WB1484803 ,02/07/2019 ,15840 ,0 ,8448 ,0 ,02/02/2017,8448,0,0,0,0  ,8448,
(3201009002/IF/IAY/971905),Construction of IAY House -IAY REG. NO. WB2371190 ,11/09/2019 ,15840 ,0 ,11616 ,0 ,28/01/2017,11616,0,0,0,0  ,11616,
(3201009002/IF/IAY/977968),Construction of IAY House -IAY REG. NO. WB2354627 ,11/09/2019 ,15840 ,0 ,9504 ,0 ,02/02/2017,9504,0,0,0,0  ,9504,
(3201009002/IF/IAY/956821),Construction of IAY House -IAY REG. NO. WB1325285 ,02/07/2019 ,15840 ,0 ,8448 ,0 ,28/01/2017,8448,0,0,0,0  ,8448,
(3201009002/IF/IAY/956901),Construction of IAY House -IAY REG. NO. WB1328393 ,11/09/2019 ,15840 ,0 ,13728 ,0 ,28/01/2017,13728,0,0,0,0  ,13728,
(3201009002/WC/704010330485),Exacavation of farm pond of Pashupati majhi at Sijaipur. ,03/07/2019 ,187020 ,39840 ,75960 ,9290 ,28/04/2017,75960,0,7290,2000,0  ,85250,
(3201009002/IF/IAY/2308781),Construction of PMAY-G House for Individuals -PMAY-G  REG. NO. WB3813815 ,02/12/2019 ,17190 ,0 ,16044 ,0 ,12/02/2018,16044,0,0,0,0  ,16044,
(3201009002/IF/IAY/4116451),Construction of PMAY-G House for Individuals -PMAY-G  REG. NO. WB1620277 ,20/05/2022 ,20070 ,0 ,19320 ,0 ,10/06/2020,19320,0,0,0,0  ,19320,
(3201009002/IF/IAY/2307772),Construction of PMAY-G House for Individuals -PMAY-G  REG. NO. WB3701454 ,30/10/2019 ,17190 ,0 ,17190 ,0 ,12/02/2018,17190,0,0,0,0  ,17190,
(3201009002/IF/IAY/2163533),Construction of PMAY-G House for Individuals -PMAY-G  REG. NO. WB3643909 ,02/07/2019 ,17190 ,0 ,16808 ,0 ,21/02/2018,16808,0,0,0,0  ,16808,
(3201009002/IF/IAY/2163386),Construction of PMAY-G House for Individuals -PMAY-G  REG. NO. WB1918908 ,02/12/2019 ,17190 ,0 ,13752 ,0 ,12/02/2018,13752,0,0,0,0  ,13752,
(3201009002/IF/IAY/2158875),Construction of PMAY-G House for Individuals -PMAY-G  REG. NO. WB3798375 ,02/07/2019 ,17190 ,0 ,16808 ,0 ,24/01/2018,16808,0,0,0,0  ,16808,
(3201009002/IF/IAY/2157201),Construction of PMAY-G House for Individuals -PMAY-G  REG. NO. WB3007092 ,16/09/2019 ,17190 ,0 ,17190 ,0 ,24/01/2018,17190,0,0,0,0  ,17190,
(3201009002/IF/IAY/2155647),Construction of PMAY-G House for Individuals -PMAY-G  REG. NO. WB1503266 ,23/09/2019 ,17190 ,0 ,16044 ,0 ,12/02/2018,16044,0,0,0,0  ,16044,
(3201009002/IF/IAY/2163085),Construction of PMAY-G House for Individuals -PMAY-G  REG. NO. WB1576785 ,02/07/2019 ,17190 ,0 ,16808 ,0 ,21/02/2018,16808,0,0,0,0  ,16808,
(3201009002/IF/321002041046402),EXCAVATION OF FARM POND ON THE L/O MOHAN CH. DAS AT ANANDABAS UNDER BHALUKA GP ,10/03/2020 ,94907.59 ,3000 ,84950 ,5786 ,22/11/2019,84950,0,2790,2996,0  ,90736,
(3201009002/IF/IAY/949008),Construction of IAY House -IAY REG. NO. WB1067251 ,02/07/2019 ,15840 ,0 ,6336 ,0 ,28/01/2017,6336,0,0,0,0  ,6336,
(3201009002/IF/321002040964371),Construction of Gitanjali house of the beneficiary Jaydeb Mistri. ,26/08/2019 ,17190 ,0 ,17190 ,0 ,04/01/2019,17190,0,0,0,0  ,17190,
(3201009002/IF/22012034454614),Excavation of farm pond of Najarali Mondal at Anandabas . ,02/07/2019 ,245160 ,43080 ,225590 ,16040 ,26/04/2017,225590,0,14040,2000,0  ,241630,
(3201009002/IF/IAY/4116493),Construction of PMAY-G House for Individuals -PMAY-G  REG. NO. WB1949847 ,16/05/2022 ,20070 ,0 ,19320 ,0 ,24/06/2020,19320,0,0,0,0  ,19320,
(3201009002/IF/22012034444305),Construction of Gitanjali House of beneficiary Amar Mistri at Bhaluka ,02/07/2019 ,15840 ,0 ,15840 ,0 ,18/01/2017,15840,0,0,0,0  ,15840,
(3201009002/IF/IAY/952484),Construction of IAY House -IAY REG. NO. WB1193028 ,11/09/2019 ,15840 ,0 ,12672 ,0 ,28/01/2017,12672,0,0,0,0  ,12672,
(3201009002/IF/IAY/2150043),Construction of PMAY-G House for Individuals -PMAY-G  REG. NO. WB1523147 ,02/07/2019 ,17190 ,0 ,16808 ,0 ,12/02/2018,16808,0,0,0,0  ,16808,
(3201009002/IF/22012034361656),Construction of vermi composing in the land of kamal Majhi at Bhaluka. ,02/07/2019 ,3168 ,10462 ,0 ,1500 ,22/12/2016,0,0,0,1500,0  ,1500,
(3201009002/IF/IAY/944488),Construction of IAY House -IAY REG. NO. WB1324096 ,11/09/2019 ,15840 ,0 ,11616 ,0 ,27/01/2017,11616,0,0,0,0  ,11616,
(3201009002/FP/320201060483617),Construction of CC Drain from S/O Nilu Biswas to S/O Akshay Roy at Bhaluka . ,17/12/2019 ,33425 ,309027 ,33425 ,304652.0465 ,21/01/2019,33425,34819,1719,268114.0465,0  ,338077.0465,
(3201009002/IF/22012034444265),Construction of Gitanjali House of beneficiary Abu Hanip Sekh at Anandabas ,28/12/2019 ,15840 ,0 ,16032 ,0 ,18/01/2017,16032,0,0,0,0  ,16032,
(3201009002/IF/22012034454573),Excavation of farm pond of Abdul Hannan Sekh at Anandabas. ,02/07/2019 ,176040 ,39030 ,162082 ,9720 ,26/04/2017,162082,0,9720,0,0  ,171802,
(3201009002/FP/320201060427160),Earth work in earthen boundh for flood protection on from L/O Sankar Sardar to H/O Rahaman Sekh. ,02/07/2019 ,231300 ,16770 ,239400 ,16850 ,28/12/2017,239400,0,14850,2000,0  ,256250,
(3201009002/IF/IAY/4116487),Construction of PMAY-G House for Individuals -PMAY-G  REG. NO. WB2790863 ,15/05/2022 ,20070 ,0 ,18936 ,0 ,10/06/2020,18936,0,0,0,0  ,18936,
(3201009002/IF/22012034368580),Construction of gitanjali house of Akbar Sekh at Anandabas. ,02/07/2019 ,15840 ,0 ,14760 ,0 ,24/01/2017,14760,0,0,0,0  ,14760,
(3201009002/FP/320201060483619),Construction of CC Drain from S/O Akshay Roy to Bhaluka Dighi at Bhaluka . ,17/12/2019 ,34953 ,302059 ,24448 ,293239.4725 ,21/01/2019,24448,30178,1432.5,261628.9725,0  ,317687.4725,
(3201009002/IF/IAY/4116456),Construction of PMAY-G House for Individuals -PMAY-G  REG. NO. WB2780112 ,15/05/2022 ,20070 ,0 ,18936 ,0 ,10/06/2020,18936,0,0,0,0  ,18936,
